country,arrival_date_year,arrival_date_month,reservations,stays,cancellations,cancellationRate,total_parking_required,total_special_requests,city_hotels,resort_hotels,transients,transient_parties,contracts,group,adults,children,babies,guests
PRT,2015,October,2870,1272,1598,0.556794425087108,108,726,2206,664,1379,1112,361,18,5030,84.0,10,5124.0
PRT,2016,March,2077,1130,947,0.45594607607125665,154,712,1114,963,1640,413,19,5,3536,137.0,14,3687.0
PRT,2016,February,2105,1064,1041,0.49453681710213776,138,630,1136,969,1512,575,13,5,3597,106.0,10,3713.0
PRT,2015,September,2888,998,1890,0.6544321329639889,73,752,2293,595,1414,1126,322,26,5533,95.0,18,5646.0
PRT,2016,April,2331,992,1339,0.5744315744315744,135,587,1426,905,1703,602,19,7,4153,128.0,14,4295.0
PRT,2015,August,2445,960,1485,0.6073619631901841,143,1254,1548,897,1194,954,291,6,4739,289.0,50,5078.0
PRT,2016,May,2277,897,1380,0.6060606060606061,108,645,1531,746,1633,621,20,3,3977,90.0,12,4079.0
PRT,2017,February,1561,880,681,0.43625880845611786,116,703,831,730,1193,341,4,23,2639,110.0,14,2763.0
PRT,2016,June,2432,875,1557,0.6402138157894737,117,796,1897,535,1914,492,23,3,4229,143.0,17,4389.0
PRT,2017,January,1502,868,634,0.422103861517976,141,549,856,646,1174,316,0,12,2346,81.0,7,2434.0
PRT,2015,July,2077,867,1210,0.5825710158883004,111,714,1300,777,1028,813,233,3,4034,166.0,19,4219.0
PRT,2016,July,1566,831,735,0.46934865900383144,151,897,956,610,1338,201,26,1,2963,291.0,31,3285.0
PRT,2015,November,1296,816,480,0.37037037037037035,91,454,675,621,668,518,102,8,1968,51.0,15,2034.0
PRT,2015,December,1731,812,919,0.5309069901790873,109,702,944,787,1300,336,86,9,2980,122.0,26,3128.0
PRT,2016,December,1327,800,527,0.3971363978899774,134,706,679,648,1029,278,0,20,2299,135.0,9,2443.0
PRT,2017,March,1649,741,908,0.5506367495451789,96,502,1006,643,1341,291,2,15,2754,44.0,7,2805.0
GBR,2016,October,863,738,125,0.14484356894553882,70,482,267,596,480,353,27,3,1606,89.0,9,1704.0
PRT,2016,January,1160,732,428,0.3689655172413793,105,413,645,515,932,212,14,2,1806,47.0,18,1871.0
PRT,2017,August,1302,718,584,0.4485407066052227,133,1086,605,697,1083,187,16,16,2519,321.0,25,2865.0
PRT,2016,November,1720,695,1025,0.5959302325581395,124,586,1200,520,1528,179,1,12,2862,66.0,5,2933.0
PRT,2016,August,1407,663,744,0.5287846481876333,153,792,662,745,1249,141,15,2,2812,318.0,42,3172.0
GBR,2017,May,936,658,278,0.297008547008547,40,688,428,508,654,157,123,2,1828,122.0,13,1963.0
PRT,2016,September,1881,628,1253,0.6661350345560871,117,625,1350,531,1549,318,10,4,3439,83.0,21,3543.0
GBR,2017,June,845,612,233,0.2757396449704142,16,678,473,372,658,70,112,5,1669,68.0,1,1738.0
PRT,2016,October,2038,609,1429,0.7011776251226692,115,434,1435,603,1468,557,6,7,3587,55.0,6,3648.0
GBR,2016,September,743,604,139,0.18707940780619112,41,522,374,369,485,164,93,1,1447,69.0,5,1521.0
PRT,2017,June,1943,594,1349,0.6942871847658261,127,705,1341,602,1672,225,33,13,3431,122.0,12,3565.0
PRT,2017,July,1262,578,684,0.5419968304278923,122,807,640,622,1085,155,15,7,2409,243.0,16,2668.0
PRT,2017,May,2040,573,1467,0.7191176470588235,90,575,1552,488,1704,311,10,15,3408,46.0,9,3463.0
GBR,2016,May,621,557,64,0.10305958132045089,63,317,227,394,344,181,85,11,1163,53.0,7,1223.0
FRA,2017,March,651,547,104,0.1597542242703533,17,450,555,96,483,156,12,0,1217,21.0,4,1242.0
GBR,2017,July,711,530,181,0.2545710267229255,9,623,463,248,537,106,66,2,1441,88.0,4,1533.0
GBR,2017,April,695,523,172,0.2474820143884892,37,488,308,387,466,151,75,3,1308,71.0,2,1381.0
DEU,2016,October,583,498,85,0.1457975986277873,10,464,522,61,335,246,0,2,1126,32.0,0,1158.0
PRT,2017,April,1703,478,1225,0.7193188490898414,89,498,1132,571,1400,284,11,8,3081,95.0,10,3186.0
GBR,2016,June,533,477,56,0.1050656660412758,34,359,191,342,362,32,139,0,1018,35.0,8,1061.0
FRA,2016,October,625,476,149,0.2384,17,446,569,56,494,130,0,1,1166,76.0,5,1247.0
FRA,2016,May,544,470,74,0.13602941176470587,39,282,465,79,364,179,1,0,1051,44.0,1,1096.0
GBR,2017,March,585,470,115,0.19658119658119658,22,397,297,288,446,128,8,3,1046,32.0,3,1081.0
ESP,2016,March,581,468,113,0.1944922547332186,98,304,311,270,435,146,0,0,1150,111.0,13,1274.0
ESP,2015,August,497,457,40,0.08048289738430583,46,295,335,162,249,206,42,0,991,38.0,7,1036.0
FRA,2017,May,603,453,150,0.24875621890547264,35,501,521,82,551,49,3,0,1165,53.0,4,1222.0
FRA,2016,August,603,444,159,0.263681592039801,63,546,533,70,562,37,1,3,1250,151.0,9,1410.0
FRA,2016,November,484,442,42,0.08677685950413223,31,416,349,135,458,26,0,0,919,13.0,8,940.0
GBR,2017,February,562,440,122,0.21708185053380782,24,387,237,325,425,120,16,1,1065,61.0,1,1127.0
GBR,2015,October,462,439,23,0.049783549783549784,29,242,98,364,207,147,98,10,838,23.0,14,875.0
FRA,2016,April,516,432,84,0.16279069767441862,36,378,450,66,412,99,1,4,1036,104.0,2,1142.0
GBR,2017,August,604,427,177,0.29304635761589404,13,558,367,237,440,62,88,14,1224,146.0,0,1370.0
ESP,2016,August,653,424,229,0.35068912710566613,116,475,365,288,617,35,0,1,1389,179.0,13,1581.0
DEU,2017,July,519,417,102,0.19653179190751446,4,357,493,26,326,192,0,1,980,69.0,0,1049.0
FRA,2017,April,558,409,149,0.2670250896057348,34,478,472,86,496,60,2,0,1142,108.0,5,1255.0
ESP,2015,December,429,397,32,0.07459207459207459,59,244,233,196,260,135,31,3,826,47.0,14,887.0
DEU,2016,May,449,395,54,0.12026726057906459,18,194,299,150,262,183,4,0,831,29.0,1,861.0
DEU,2016,April,427,386,41,0.09601873536299765,13,146,251,176,240,185,2,0,755,9.0,0,764.0
DEU,2016,September,453,383,70,0.1545253863134658,18,286,415,38,262,187,3,1,846,29.0,1,876.0
FRA,2017,February,489,379,110,0.2249488752556237,9,341,417,72,465,20,4,0,971,94.0,7,1072.0
GBR,2016,July,481,372,109,0.22661122661122662,15,311,286,195,357,60,63,1,994,67.0,2,1063.0
FRA,2015,September,394,364,30,0.07614213197969544,21,149,265,129,108,248,35,3,691,4.0,0,695.0
GBR,2016,April,452,360,92,0.20353982300884957,15,219,184,268,340,91,21,0,833,34.0,1,868.0
DEU,2017,June,427,356,71,0.16627634660421545,11,300,391,36,321,100,0,6,818,31.0,1,850.0
DEU,2017,April,466,353,113,0.24248927038626608,15,379,380,86,333,112,21,0,916,47.0,0,963.0
FRA,2016,December,431,345,86,0.19953596287703015,20,316,313,118,395,36,0,0,845,37.0,4,886.0
FRA,2017,August,526,343,183,0.34790874524714827,29,524,442,84,472,52,0,2,1101,113.0,5,1219.0
GBR,2016,August,488,341,147,0.3012295081967213,16,349,293,195,388,48,51,1,984,127.0,4,1115.0
DEU,2016,August,421,336,85,0.20190023752969122,15,278,385,36,281,131,8,1,844,50.0,3,897.0
FRA,2016,June,387,335,52,0.1343669250645995,20,267,357,30,252,133,1,1,758,24.0,1,783.0
GBR,2016,March,403,333,70,0.17369727047146402,18,191,176,227,293,98,7,5,794,26.0,2,822.0
DEU,2016,June,374,333,41,0.10962566844919786,16,252,338,36,180,190,4,0,707,7.0,3,717.0
ESP,2017,August,555,323,232,0.418018018018018,59,630,232,323,518,37,0,0,1151,195.0,8,1354.0
FRA,2015,October,323,322,1,0.0030959752321981426,9,182,254,69,102,159,46,16,626,15.0,3,644.0
ESP,2016,December,506,314,192,0.3794466403162055,46,393,316,190,411,94,0,1,986,102.0,6,1094.0
DEU,2017,March,399,311,88,0.22055137844611528,13,223,296,103,314,84,0,1,744,3.0,0,747.0
ESP,2017,February,376,311,65,0.17287234042553193,38,258,224,152,231,143,0,2,672,38.0,4,714.0
DEU,2017,May,424,311,113,0.2665094339622642,14,289,363,61,357,65,1,1,798,11.0,0,809.0
FRA,2016,September,395,310,85,0.21518987341772153,20,324,362,33,288,106,0,1,758,23.0,1,782.0
ESP,2015,September,314,310,4,0.012738853503184714,41,164,219,95,120,147,47,0,605,28.0,2,635.0
FRA,2017,June,429,309,120,0.27972027972027974,16,295,395,34,380,47,1,1,854,50.0,2,906.0
FRA,2016,July,395,309,86,0.21772151898734177,37,338,362,33,337,58,0,0,816,85.0,3,904.0
GBR,2015,September,393,301,92,0.2340966921119593,9,161,75,318,221,31,141,0,695,2.0,1,698.0
GBR,2016,November,391,298,93,0.23785166240409208,8,339,185,206,361,27,2,1,728,23.0,2,753.0
DEU,2017,August,369,292,77,0.2086720867208672,11,310,343,26,281,88,0,0,728,41.0,0,769.0
FRA,2016,February,322,290,32,0.09937888198757763,21,201,274,48,283,38,0,1,627,45.0,2,674.0
FRA,2016,March,322,278,44,0.13664596273291926,16,172,294,28,274,48,0,0,604,16.0,2,622.0
ESP,2016,February,316,274,42,0.13291139240506328,48,197,132,184,235,78,2,1,604,46.0,5,655.0
FRA,2017,July,368,262,106,0.28804347826086957,14,318,324,44,346,19,2,1,751,76.0,3,830.0
DEU,2016,July,295,262,33,0.11186440677966102,10,194,270,25,159,132,4,0,591,33.0,4,628.0
ESP,2015,October,312,256,56,0.1794871794871795,42,177,120,192,202,75,31,4,590,14.0,2,606.0
DEU,2016,March,284,253,31,0.10915492957746478,12,150,230,54,226,56,2,0,533,26.0,1,560.0
ESP,2017,April,402,241,161,0.40049751243781095,69,353,206,196,377,25,0,0,800,84.0,4,888.0
ESP,2017,January,301,235,66,0.21926910299003322,35,210,185,116,242,59,0,0,523,24.0,2,549.0
ESP,2017,July,383,234,149,0.38903394255874674,44,330,174,209,354,29,0,0,770,94.0,5,869.0
FRA,2015,November,229,227,2,0.008733624454148471,10,57,187,42,109,89,13,18,394,2.0,1,397.0
ESP,2016,July,352,216,136,0.38636363636363635,58,234,185,167,322,30,0,0,729,71.0,12,812.0
FRA,2017,January,278,211,67,0.24100719424460432,15,222,213,65,261,16,0,1,523,10.0,2,535.0
GBR,2016,February,231,210,21,0.09090909090909091,11,146,87,144,192,23,8,8,424,24.0,3,451.0
IRL,2017,May,297,209,88,0.2962962962962963,7,239,104,193,237,56,4,0,557,18.0,2,577.0
ESP,2016,October,278,203,75,0.2697841726618705,37,233,164,114,258,20,0,0,502,26.0,3,531.0
ITA,2016,September,230,196,34,0.14782608695652175,6,164,217,13,86,142,0,2,424,9.0,0,433.0
ESP,2015,November,194,194,0,0.0,32,101,53,141,103,71,15,5,342,4.0,1,347.0
GBR,2017,January,250,194,56,0.224,17,192,89,161,214,31,3,2,464,18.0,2,484.0
FRA,2015,December,202,194,8,0.039603960396039604,14,96,175,27,149,34,11,8,387,9.0,1,397.0
ESP,2015,July,186,186,0,0.0,43,132,18,168,150,34,2,0,374,20.0,4,398.0
IRL,2016,May,198,183,15,0.07575757575757576,4,156,51,147,179,15,4,0,388,14.0,3,405.0
ESP,2016,November,248,183,65,0.2620967741935484,26,221,156,92,234,13,0,1,443,13.0,3,459.0
ESP,2016,April,268,181,87,0.3246268656716418,39,138,132,136,214,54,0,0,511,35.0,2,548.0
ESP,2016,September,264,180,84,0.3181818181818182,36,260,167,97,236,28,0,0,507,47.0,6,560.0
FRA,2015,August,180,179,1,0.005555555555555556,23,167,139,41,105,23,50,2,344,30.0,2,376.0
GBR,2016,December,262,178,84,0.32061068702290074,12,217,92,170,235,25,1,1,494,41.0,0,535.0
IRL,2017,June,295,177,118,0.4,6,266,100,195,271,24,0,0,599,53.0,1,653.0
BEL,2017,July,224,165,59,0.26339285714285715,15,188,183,41,195,28,0,1,486,60.0,2,548.0
DEU,2016,November,218,164,54,0.24770642201834864,7,185,162,56,213,4,1,0,382,2.0,0,384.0
DEU,2015,October,157,157,0,0.0,6,68,135,22,59,72,20,6,290,5.0,0,295.0
IRL,2016,September,196,155,41,0.20918367346938777,6,170,58,138,139,55,1,1,382,24.0,0,406.0
AUT,2016,May,160,151,9,0.05625,0,46,148,12,45,114,1,0,298,7.0,0,305.0
ITA,2016,August,260,150,110,0.4230769230769231,12,150,216,44,235,25,0,0,562,52.0,0,614.0
GBR,2015,July,144,144,0,0.0,5,106,3,141,75,2,66,1,282,14.0,1,297.0
ESP,2016,January,165,143,22,0.13333333333333333,30,92,84,81,140,23,0,2,296,26.0,0,322.0
ESP,2017,May,202,143,59,0.29207920792079206,24,146,119,83,188,10,0,4,352,33.0,2,387.0
ITA,2017,January,210,139,71,0.3380952380952381,6,156,157,53,163,47,0,0,403,19.0,1,423.0
BEL,2017,May,178,137,41,0.2303370786516854,4,177,154,24,168,8,0,2,334,14.0,0,348.0
IRL,2015,September,176,135,41,0.23295454545454544,7,104,10,166,81,66,28,1,343,7.0,2,352.0
BRA,2016,December,202,135,67,0.3316831683168317,10,151,183,19,129,73,0,0,410,45.0,1,456.0
IRL,2016,October,245,133,112,0.45714285714285713,6,191,92,153,184,59,2,0,470,25.0,2,497.0
ESP,2016,June,204,133,71,0.3480392156862745,37,129,141,63,178,26,0,0,391,33.0,1,425.0
ESP,2016,May,189,131,58,0.30687830687830686,34,85,120,69,163,26,0,0,361,36.0,2,399.0
FRA,2016,January,141,131,10,0.07092198581560284,7,91,115,26,121,20,0,0,256,5.0,0,261.0
ITA,2015,August,198,131,67,0.3383838383838384,1,43,189,9,29,164,3,2,384,5.0,0,389.0
IRL,2017,April,192,130,62,0.3229166666666667,4,134,106,86,164,27,0,1,367,16.0,1,384.0
ESP,2017,March,180,130,50,0.2777777777777778,27,136,118,62,162,17,0,1,328,26.0,0,354.0
GBR,2015,November,129,129,0,0.0,12,64,33,96,90,19,14,6,231,2.0,0,233.0
IRL,2017,March,163,129,34,0.2085889570552147,1,143,98,65,138,25,0,0,314,5.0,1,320.0
DEU,2015,September,129,127,2,0.015503875968992248,7,59,93,36,58,47,22,2,236,3.0,1,240.0
ESP,2017,June,213,124,89,0.41784037558685444,32,145,102,111,203,10,0,0,422,42.0,5,469.0
IRL,2016,June,141,124,17,0.12056737588652482,2,105,37,104,130,9,2,0,281,7.0,3,291.0
IRL,2016,April,145,122,23,0.15862068965517243,4,70,43,102,111,34,0,0,268,9.0,2,279.0
DEU,2017,February,163,120,43,0.26380368098159507,6,136,135,28,160,3,0,0,307,6.0,0,313.0
ITA,2016,April,192,119,73,0.3802083333333333,5,106,185,7,147,45,0,0,381,32.0,2,415.0
USA,2017,August,183,119,64,0.34972677595628415,7,196,137,46,158,25,0,0,361,57.0,0,418.0
GBR,2015,December,119,119,0,0.0,11,78,25,94,90,17,10,2,225,3.0,3,231.0
USA,2017,May,176,117,59,0.3352272727272727,4,155,149,27,165,9,0,2,328,8.0,1,337.0
BEL,2016,July,142,117,25,0.176056338028169,13,108,130,12,112,28,2,0,287,42.0,0,329.0
ITA,2015,September,118,116,2,0.01694915254237288,7,51,96,22,35,70,12,1,212,7.0,0,219.0
ITA,2017,April,207,115,92,0.4444444444444444,9,132,182,25,158,48,0,1,426,27.0,0,453.0
BEL,2016,August,134,114,20,0.14925373134328357,10,128,131,3,99,28,7,0,273,36.0,0,309.0
ITA,2016,December,217,113,104,0.4792626728110599,5,221,199,18,203,14,0,0,439,39.0,3,481.0
DEU,2016,February,125,113,12,0.096,4,64,101,24,109,16,0,0,233,4.0,0,237.0
USA,2017,June,150,113,37,0.24666666666666667,9,143,118,32,129,19,0,2,299,32.0,0,331.0
GBR,2016,January,117,113,4,0.03418803418803419,8,66,46,71,103,9,5,0,206,1.0,1,208.0
CN,2017,July,151,110,41,0.271523178807947,9,112,65,86,144,7,0,0,308,16.0,0,324.0
GBR,2015,August,109,109,0,0.0,9,79,11,98,64,2,42,1,216,14.0,3,233.0
ITA,2017,March,161,109,52,0.32298136645962733,4,95,138,23,147,14,0,0,310,13.0,0,323.0
BEL,2016,September,132,109,23,0.17424242424242425,8,116,108,24,95,37,0,0,260,14.0,0,274.0
CHE,2017,May,149,107,42,0.28187919463087246,10,129,127,22,126,23,0,0,286,17.0,0,303.0
ITA,2017,August,205,107,98,0.47804878048780486,8,167,169,36,194,11,0,0,421,36.0,1,458.0
ITA,2016,November,165,106,59,0.3575757575757576,6,137,147,18,155,10,0,0,308,14.0,0,322.0
ITA,2017,May,154,106,48,0.3116883116883117,6,113,140,14,137,16,0,1,302,13.0,1,316.0
IRL,2016,July,128,106,22,0.171875,2,85,60,68,120,7,1,0,263,16.0,0,279.0
DEU,2017,January,131,105,26,0.1984732824427481,10,109,102,29,109,19,0,3,230,13.0,2,245.0
IRL,2017,July,172,105,67,0.38953488372093026,1,156,91,81,159,11,1,1,361,28.0,1,390.0
BEL,2016,October,147,105,42,0.2857142857142857,10,187,114,33,129,18,0,0,279,4.0,1,284.0
CN,2017,May,135,104,31,0.22962962962962963,10,95,56,79,109,25,0,1,266,9.0,0,275.0
NLD,2016,April,121,102,19,0.15702479338842976,7,57,84,37,86,34,1,0,226,15.0,0,241.0
ITA,2016,May,141,100,41,0.2907801418439716,6,93,130,11,106,35,0,0,269,14.0,0,283.0
CN,2017,June,116,100,16,0.13793103448275862,10,82,38,78,84,30,0,2,221,11.0,1,233.0
NLD,2016,August,118,100,18,0.15254237288135594,17,107,103,15,95,22,1,0,242,34.0,2,278.0
USA,2017,July,157,99,58,0.36942675159235666,6,121,117,40,149,8,0,0,323,46.0,0,369.0
NLD,2017,March,127,99,28,0.2204724409448819,8,107,78,49,98,29,0,0,234,5.0,1,240.0
USA,2016,September,128,98,30,0.234375,11,97,103,25,113,15,0,0,235,8.0,2,245.0
NLD,2016,November,115,97,18,0.1565217391304348,11,113,82,33,109,6,0,0,205,4.0,0,209.0
ITA,2016,March,147,97,50,0.3401360544217687,6,68,131,16,114,30,3,0,284,19.0,0,303.0
USA,2016,June,119,96,23,0.19327731092436976,11,100,93,26,86,32,0,1,233,29.0,0,262.0
IRL,2017,August,139,94,45,0.3237410071942446,2,141,74,65,120,12,6,1,280,22.0,1,303.0
BEL,2017,April,147,92,55,0.3741496598639456,1,120,132,15,136,11,0,0,303,22.0,0,325.0
CHE,2016,October,121,92,29,0.2396694214876033,5,114,109,12,110,11,0,0,249,29.0,0,278.0
USA,2016,October,108,92,16,0.14814814814814814,12,82,85,23,94,11,0,3,176,5.0,0,181.0
BRA,2017,May,174,91,83,0.47701149425287354,8,180,128,46,155,19,0,0,350,13.0,1,364.0
USA,2016,July,117,89,28,0.23931623931623933,9,76,76,41,88,29,0,0,229,28.0,0,257.0
ITA,2016,October,152,89,63,0.4144736842105263,7,117,137,15,135,17,0,0,294,16.0,1,311.0
CN,2016,September,110,89,21,0.19090909090909092,11,80,35,75,74,36,0,0,209,3.0,0,212.0
CHE,2017,July,156,89,67,0.42948717948717946,8,142,89,67,144,12,0,0,309,64.0,2,375.0
BEL,2017,March,97,87,10,0.10309278350515463,4,64,58,39,64,33,0,0,178,2.0,0,180.0
NLD,2017,April,119,87,32,0.2689075630252101,3,80,102,17,89,30,0,0,209,18.0,0,227.0
BEL,2016,April,104,87,17,0.16346153846153846,4,71,77,27,75,27,1,1,190,6.0,0,196.0
IRL,2015,October,112,87,25,0.22321428571428573,3,63,25,87,74,27,11,0,214,11.0,0,225.0
BRA,2017,July,148,86,62,0.4189189189189189,5,146,112,36,135,12,0,1,305,54.0,3,362.0
ISR,2017,March,89,86,3,0.033707865168539325,0,75,89,0,5,83,0,1,157,0.0,0,157.0
BEL,2017,June,114,85,29,0.2543859649122807,5,97,96,18,105,7,0,2,232,4.0,0,236.0
NLD,2016,July,105,84,21,0.2,10,70,88,17,91,14,0,0,206,32.0,0,238.0
BRA,2017,March,120,84,36,0.3,5,128,111,9,116,1,0,3,237,19.0,1,257.0
DEU,2016,December,151,84,67,0.44370860927152317,5,128,131,20,138,12,0,1,277,21.0,0,298.0
BRA,2017,January,161,83,78,0.484472049689441,9,148,130,31,148,8,0,5,326,46.0,1,373.0
BEL,2017,August,116,83,33,0.28448275862068967,4,101,105,11,108,7,0,1,238,38.0,0,276.0
SWE,2016,October,139,83,56,0.4028776978417266,25,49,53,86,88,51,0,0,255,26.0,0,281.0
NLD,2017,May,102,83,19,0.18627450980392157,3,106,91,11,79,23,0,0,192,10.0,1,203.0
NLD,2016,June,100,82,18,0.18,8,69,85,15,86,14,0,0,174,4.0,1,179.0
ITA,2016,January,93,82,11,0.11827956989247312,3,50,79,14,56,36,0,1,173,3.0,2,178.0
BEL,2016,March,96,81,15,0.15625,4,56,79,17,77,19,0,0,192,8.0,1,201.0
IRL,2016,November,101,81,20,0.19801980198019803,1,85,43,58,85,16,0,0,199,2.0,0,201.0
IRL,2016,August,109,81,28,0.25688073394495414,3,79,46,63,101,6,2,0,214,20.0,1,235.0
NLD,2016,May,101,80,21,0.2079207920792079,4,61,79,22,90,10,0,1,185,13.0,0,198.0
NLD,2016,October,108,80,28,0.25925925925925924,14,107,85,23,97,11,0,0,213,16.0,1,230.0
ISR,2015,October,80,80,0,0.0,0,20,79,1,5,73,2,0,157,0.0,0,157.0
CHE,2016,July,90,77,13,0.14444444444444443,9,78,65,25,73,16,1,0,182,26.0,0,208.0
DEU,2015,December,77,77,0,0.0,4,28,53,24,36,36,5,0,115,4.0,0,119.0
NLD,2017,June,103,76,27,0.2621359223300971,5,72,94,9,99,4,0,0,193,10.0,0,203.0
ITA,2016,July,130,76,54,0.4153846153846154,5,88,116,14,99,31,0,0,284,27.0,0,311.0
BEL,2016,November,93,76,17,0.1827956989247312,4,123,73,20,89,4,0,0,174,5.0,2,181.0
AUT,2017,April,96,76,20,0.20833333333333334,2,76,61,35,63,31,1,1,187,8.0,0,195.0
DEU,2016,January,85,75,10,0.11764705882352941,4,22,70,15,74,10,1,0,129,0.0,0,129.0
NLD,2017,August,94,75,19,0.20212765957446807,5,86,85,9,85,9,0,0,194,40.0,0,234.0
CN,2016,July,92,74,18,0.1956521739130435,10,76,43,49,79,13,0,0,191,15.0,1,207.0
DEU,2015,November,74,74,0,0.0,5,47,53,21,47,10,16,1,122,0.0,1,123.0
CN,2017,August,94,73,21,0.22340425531914893,5,97,42,52,85,9,0,0,186,27.0,4,217.0
CHE,2016,April,89,73,16,0.1797752808988764,5,59,80,9,69,20,0,0,178,11.0,0,189.0
NLD,2016,September,95,73,22,0.23157894736842105,10,112,78,17,84,10,0,1,185,5.0,1,191.0
ITA,2015,October,73,73,0,0.0,2,48,68,5,16,33,21,3,126,1.0,1,128.0
CHE,2017,April,99,72,27,0.2727272727272727,6,80,70,29,92,3,4,0,193,21.0,1,215.0
BRA,2016,September,106,71,35,0.330188679245283,1,83,92,14,82,24,0,0,218,10.0,5,233.0
IRL,2015,August,71,71,0,0.0,1,71,3,68,55,6,10,0,144,8.0,1,153.0
CHE,2017,June,91,71,20,0.21978021978021978,10,74,70,21,76,15,0,0,170,10.0,0,180.0
IRL,2015,July,70,70,0,0.0,1,43,0,70,38,4,28,0,139,6.0,0,145.0
CN,2015,September,69,69,0,0.0,7,22,34,35,24,41,4,0,132,2.0,0,134.0
BEL,2016,May,83,69,14,0.1686746987951807,10,49,70,13,73,9,1,0,155,12.0,1,168.0
CHE,2016,September,87,69,18,0.20689655172413793,10,76,61,26,75,12,0,0,168,5.0,3,176.0
DEU,2015,August,69,69,0,0.0,1,25,67,2,18,47,4,0,129,0.0,0,129.0
SWE,2015,September,69,69,0,0.0,0,21,57,12,15,48,6,0,91,0.0,0,91.0
SWE,2017,April,88,69,19,0.2159090909090909,0,65,50,38,49,37,0,2,168,9.0,3,180.0
BRA,2016,October,112,68,44,0.39285714285714285,10,107,86,26,100,10,0,2,228,13.0,0,241.0
NLD,2016,February,74,68,6,0.08108108108108109,13,39,50,24,69,5,0,0,132,7.0,1,140.0
USA,2017,April,102,68,34,0.3333333333333333,7,74,85,17,97,5,0,0,202,17.0,0,219.0
NLD,2017,February,82,68,14,0.17073170731707318,8,79,53,29,76,6,0,0,156,20.0,1,177.0
ITA,2017,June,111,68,43,0.38738738738738737,3,77,98,13,105,6,0,0,218,25.0,1,244.0
NLD,2017,July,98,67,31,0.3163265306122449,5,84,82,16,84,14,0,0,200,16.0,0,216.0
BRA,2017,April,126,67,59,0.46825396825396826,8,103,102,24,117,9,0,0,254,19.0,1,274.0
SRB,2016,June,66,66,0,0.0,0,1,66,0,1,65,0,0,70,0.0,0,70.0
ITA,2017,February,118,66,52,0.4406779661016949,3,91,92,26,111,7,0,0,230,13.0,0,243.0
AUT,2016,April,72,65,7,0.09722222222222222,3,17,70,2,25,46,1,0,137,0.0,0,137.0
IRL,2016,March,75,65,10,0.13333333333333333,4,50,44,31,69,6,0,0,152,6.0,0,158.0
CHE,2016,May,81,65,16,0.19753086419753085,5,45,58,23,70,11,0,0,146,17.0,0,163.0
NLD,2016,March,74,64,10,0.13513513513513514,6,28,52,22,60,13,1,0,132,6.0,0,138.0
POL,2016,November,74,63,11,0.14864864864864866,4,56,47,27,52,22,0,0,122,3.0,1,126.0
NLD,2017,January,79,63,16,0.20253164556962025,8,62,54,25,73,6,0,0,149,13.0,0,162.0
AUT,2017,May,97,62,35,0.36082474226804123,3,76,91,6,94,3,0,0,182,9.0,0,191.0
USA,2016,March,75,62,13,0.17333333333333334,4,39,73,2,42,33,0,0,139,12.0,0,151.0
BEL,2016,June,76,62,14,0.18421052631578946,4,50,64,12,62,13,1,0,146,6.0,0,152.0
CN,2016,October,74,62,12,0.16216216216216217,7,49,32,42,61,10,0,3,144,3.0,0,147.0
USA,2016,May,82,62,20,0.24390243902439024,5,53,62,20,67,15,0,0,154,15.0,0,169.0
CHE,2016,June,80,61,19,0.2375,7,66,65,15,75,5,0,0,155,8.0,1,164.0
BRA,2016,November,99,61,38,0.3838383838383838,5,100,84,15,92,7,0,0,184,5.0,2,191.0
USA,2016,April,79,61,18,0.22784810126582278,6,41,63,16,64,15,0,0,148,6.0,0,154.0
USA,2016,August,86,61,25,0.29069767441860467,11,52,59,27,83,2,0,1,174,21.0,0,195.0
CN,2017,March,76,59,17,0.2236842105263158,3,48,41,35,40,35,0,1,142,2.0,0,144.0
AUT,2017,June,74,59,15,0.20270270270270271,3,37,67,7,68,6,0,0,147,5.0,0,152.0
ITA,2016,June,93,58,35,0.3763440860215054,1,64,84,9,79,13,0,1,186,24.0,1,211.0
ITA,2016,February,86,58,28,0.32558139534883723,3,54,84,2,67,18,1,0,152,13.0,1,166.0
NLD,2015,October,58,58,0,0.0,9,51,38,20,23,11,23,1,108,5.0,0,113.0
USA,2017,January,66,58,8,0.12121212121212122,3,71,57,9,40,26,0,0,95,4.0,0,99.0
IRL,2017,February,78,58,20,0.2564102564102564,2,64,39,39,74,3,0,1,142,13.0,0,155.0
ITA,2015,December,61,57,4,0.06557377049180328,5,40,49,12,28,27,6,0,118,5.0,1,124.0
ITA,2017,July,147,57,90,0.6122448979591837,4,117,128,19,147,0,0,0,300,24.0,0,324.0
USA,2015,September,57,57,0,0.0,4,38,47,10,33,12,10,2,89,2.0,0,91.0
POL,2016,June,64,56,8,0.125,1,26,20,44,29,35,0,0,123,5.0,3,131.0
BRA,2017,June,99,56,43,0.43434343434343436,7,66,85,14,99,0,0,0,202,28.0,0,230.0
USA,2017,March,75,56,19,0.25333333333333335,2,40,65,10,71,4,0,0,136,11.0,0,147.0
NOR,2017,July,90,56,34,0.37777777777777777,0,69,74,16,76,14,0,0,199,36.0,0,235.0
CHE,2016,November,71,56,15,0.2112676056338028,3,79,56,15,70,1,0,0,126,3.0,0,129.0
BRA,2016,January,69,56,13,0.18840579710144928,6,37,58,11,35,34,0,0,129,8.0,1,138.0
ISR,2017,April,79,55,24,0.3037974683544304,1,88,77,2,40,39,0,0,150,9.0,0,159.0
BEL,2017,February,69,55,14,0.2028985507246377,4,77,57,12,67,2,0,0,138,5.0,0,143.0
BEL,2015,September,69,54,15,0.21739130434782608,1,32,37,32,30,21,18,0,129,4.0,1,134.0
NOR,2016,July,55,54,1,0.01818181818181818,2,42,37,18,50,5,0,0,117,26.0,0,143.0
SWE,2017,June,67,54,13,0.19402985074626866,3,48,60,7,61,6,0,0,132,14.0,0,146.0
AUT,2016,July,60,54,6,0.1,6,52,56,4,52,7,1,0,127,7.0,0,134.0
BRA,2016,May,79,53,26,0.3291139240506329,8,58,62,17,75,4,0,0,155,14.0,1,170.0
BRA,2017,February,107,53,54,0.5046728971962616,5,82,92,15,104,3,0,0,215,19.0,2,236.0
NLD,2015,September,53,53,0,0.0,5,37,29,24,30,9,12,2,88,0.0,0,88.0
IRL,2017,January,67,52,15,0.22388059701492538,3,63,21,46,64,3,0,0,123,5.0,2,130.0
IRL,2016,December,74,52,22,0.2972972972972973,3,63,32,42,55,19,0,0,122,0.0,1,123.0
USA,2015,October,51,51,0,0.0,2,24,42,9,29,16,6,0,85,4.0,0,89.0
BEL,2015,October,51,51,0,0.0,10,62,27,24,22,14,14,1,93,0.0,0,93.0
CHE,2016,March,61,51,10,0.16393442622950818,1,24,58,3,42,14,5,0,120,8.0,0,128.0
AUT,2017,July,61,50,11,0.18032786885245902,1,45,57,4,54,7,0,0,126,8.0,0,134.0
CHE,2017,August,88,50,38,0.4318181818181818,7,79,51,37,81,7,0,0,184,9.0,0,193.0
CHN,2017,February,85,49,36,0.4235294117647059,1,63,66,19,53,32,0,0,151,7.0,0,158.0
CHE,2016,August,69,49,20,0.2898550724637681,4,43,42,27,69,0,0,0,138,2.0,0,140.0
BRA,2016,April,89,49,40,0.449438202247191,4,67,79,10,79,10,0,0,182,4.0,0,186.0
SWE,2016,July,61,48,13,0.21311475409836064,3,45,48,13,56,5,0,0,123,25.0,0,148.0
AUT,2016,February,48,48,0,0.0,0,4,46,2,10,38,0,0,92,0.0,0,92.0
SWE,2017,July,76,48,28,0.3684210526315789,5,70,50,26,76,0,0,0,149,23.0,0,172.0
AUT,2016,August,58,47,11,0.1896551724137931,4,47,56,2,52,6,0,0,125,7.0,0,132.0
AUT,2017,March,76,47,29,0.3815789473684211,23,44,51,25,54,22,0,0,137,0.0,0,137.0
CHE,2017,February,75,46,29,0.38666666666666666,3,53,64,11,73,2,0,0,142,12.0,0,154.0
BRA,2017,August,75,46,29,0.38666666666666666,3,72,50,25,70,5,0,0,150,7.0,1,158.0
NLD,2016,December,64,46,18,0.28125,7,58,46,18,63,1,0,0,114,3.0,1,118.0
RUS,2015,August,50,46,4,0.08,0,21,39,11,14,34,2,0,90,3.0,1,94.0
DNK,2017,July,62,46,16,0.25806451612903225,4,61,56,6,51,11,0,0,124,26.0,0,150.0
CN,2016,May,48,45,3,0.0625,7,42,30,18,28,18,0,2,98,0.0,0,98.0
BEL,2017,January,53,45,8,0.1509433962264151,2,50,36,17,49,4,0,0,95,5.0,1,101.0
AUT,2015,November,45,45,0,0.0,10,5,16,29,4,40,1,0,55,0.0,0,55.0
AUT,2016,March,49,45,4,0.08163265306122448,3,40,42,7,36,13,0,0,98,4.0,0,102.0
BRA,2016,March,65,43,22,0.3384615384615385,4,32,57,8,52,13,0,0,124,3.0,0,127.0
AUT,2016,October,85,43,42,0.49411764705882355,4,52,56,29,61,24,0,0,165,19.0,0,184.0
POL,2016,September,52,42,10,0.19230769230769232,5,51,33,19,49,3,0,0,104,6.0,1,111.0
CHE,2017,March,56,42,14,0.25,4,38,46,10,54,2,0,0,111,3.0,1,115.0
CN,2016,August,55,42,13,0.23636363636363636,3,33,31,24,45,9,0,1,112,9.0,3,124.0
USA,2016,December,65,41,24,0.36923076923076925,7,48,49,16,65,0,0,0,137,15.0,0,152.0
POL,2016,March,45,41,4,0.08888888888888889,4,28,34,11,23,22,0,0,83,2.0,0,85.0
CHN,2017,March,52,41,11,0.21153846153846154,2,24,31,21,38,14,0,0,101,3.0,0,104.0
BRA,2016,June,71,41,30,0.4225352112676056,12,29,52,19,63,8,0,0,143,8.0,0,151.0
SWE,2016,June,56,40,16,0.2857142857142857,6,34,31,25,49,7,0,0,112,20.0,0,132.0
USA,2016,November,52,40,12,0.23076923076923078,3,46,46,6,50,1,0,1,91,10.0,0,101.0
POL,2016,April,88,40,48,0.5454545454545454,3,44,77,11,82,6,0,0,162,10.0,1,173.0
BEL,2016,February,46,40,6,0.13043478260869565,1,29,42,4,41,5,0,0,86,6.0,1,93.0
CHN,2016,September,73,40,33,0.4520547945205479,1,61,71,2,62,11,0,0,132,13.0,0,145.0
NOR,2017,May,55,39,16,0.2909090909090909,1,41,45,10,44,11,0,0,101,2.0,0,103.0
BRA,2015,September,38,38,0,0.0,4,19,31,7,25,10,1,2,69,4.0,2,75.0
USA,2017,February,45,38,7,0.15555555555555556,3,30,26,19,44,1,0,0,86,12.0,1,99.0
AUS,2017,May,47,38,9,0.19148936170212766,1,42,42,5,25,22,0,0,88,2.0,0,90.0
IRL,2016,February,43,37,6,0.13953488372093023,3,29,15,28,43,0,0,0,84,0.0,0,84.0
AUT,2016,September,43,37,6,0.13953488372093023,5,40,33,10,38,5,0,0,88,0.0,0,88.0
CHN,2016,November,53,36,17,0.32075471698113206,0,29,51,2,32,21,0,0,100,0.0,0,100.0
BRA,2016,February,56,36,20,0.35714285714285715,4,31,52,4,51,5,0,0,102,10.0,0,112.0
BRA,2016,July,65,36,29,0.4461538461538462,9,58,46,19,61,4,0,0,137,32.0,1,170.0
IRL,2015,December,36,36,0,0.0,3,22,4,32,22,13,0,1,67,0.0,0,67.0
NLD,2015,November,35,35,0,0.0,4,28,15,20,28,1,6,0,58,0.0,0,58.0
BRA,2016,August,52,35,17,0.3269230769230769,4,43,32,20,51,1,0,0,113,17.0,1,131.0
SWE,2015,October,35,35,0,0.0,1,14,31,4,7,20,8,0,60,2.0,0,62.0
NULL,2016,March,36,35,1,0.027777777777777776,8,10,0,36,36,0,0,0,45,0.0,0,45.0
CHN,2016,February,58,35,23,0.39655172413793105,2,30,51,7,50,8,0,0,113,14.0,0,127.0
SWE,2017,May,48,35,13,0.2708333333333333,3,38,40,8,45,3,0,0,84,2.0,0,86.0
CHE,2016,December,55,35,20,0.36363636363636365,1,59,48,7,53,1,0,1,103,13.0,0,116.0
BEL,2016,December,46,35,11,0.2391304347826087,8,48,30,16,43,3,0,0,88,5.0,0,93.0
AUT,2017,August,44,34,10,0.22727272727272727,1,38,40,4,39,5,0,0,95,16.0,0,111.0
CHE,2015,October,34,34,0,0.0,3,30,23,11,25,1,7,1,64,5.0,0,69.0
NOR,2016,November,38,33,5,0.13157894736842105,0,52,34,4,24,14,0,0,66,0.0,0,66.0
NULL,2016,January,33,33,0,0.0,11,10,0,33,30,2,0,1,39,0.0,0,39.0
NULL,2016,February,34,33,1,0.029411764705882353,0,10,0,34,32,1,0,1,43,1.0,0,44.0
POL,2017,April,46,33,13,0.2826086956521739,1,46,36,10,32,13,0,1,91,17.0,0,108.0
AUT,2016,June,38,33,5,0.13157894736842105,1,25,34,4,28,10,0,0,76,2.0,0,78.0
SWE,2017,August,41,32,9,0.21951219512195122,1,46,39,2,34,7,0,0,91,2.0,0,93.0
POL,2017,June,53,32,21,0.39622641509433965,3,49,33,20,42,8,3,0,108,16.0,0,124.0
NOR,2017,June,51,32,19,0.37254901960784315,3,45,42,9,40,11,0,0,104,15.0,2,121.0
SWE,2017,March,36,32,4,0.1111111111111111,0,12,28,8,35,0,0,1,59,8.0,0,67.0
CHE,2016,February,40,32,8,0.2,0,20,38,2,33,5,1,1,72,3.0,0,75.0
CHN,2017,January,77,31,46,0.5974025974025974,3,53,71,6,76,1,0,0,148,14.0,0,162.0
SWE,2016,December,33,31,2,0.06060606060606061,0,20,30,3,16,17,0,0,52,3.0,1,56.0
POL,2017,January,36,31,5,0.1388888888888889,6,25,14,22,28,8,0,0,66,20.0,2,88.0
CZE,2016,August,31,31,0,0.0,0,4,31,0,4,27,0,0,58,1.0,0,59.0
ROU,2016,August,47,31,16,0.3404255319148936,2,19,25,22,45,2,0,0,93,14.0,1,108.0
FIN,2017,April,42,31,11,0.2619047619047619,1,33,30,12,40,2,0,0,82,3.0,0,85.0
SWE,2016,September,37,31,6,0.16216216216216217,1,43,36,1,34,3,0,0,67,3.0,0,70.0
DNK,2016,July,39,31,8,0.20512820512820512,1,31,34,5,34,4,1,0,81,19.0,2,102.0
ROU,2017,July,44,31,13,0.29545454545454547,0,45,22,22,44,0,0,0,92,14.0,0,106.0
IRL,2016,January,32,31,1,0.03125,4,20,8,24,30,2,0,0,60,0.0,0,60.0
BEL,2016,January,34,30,4,0.11764705882352941,1,19,31,3,30,4,0,0,61,0.0,1,62.0
SWE,2016,November,42,30,12,0.2857142857142857,1,29,23,19,34,8,0,0,70,6.0,0,76.0
BRA,2015,October,30,30,0,0.0,0,32,28,2,22,0,7,1,60,2.0,0,62.0
POL,2016,October,34,30,4,0.11764705882352941,2,39,23,11,18,16,0,0,58,3.0,0,61.0
POL,2016,August,46,30,16,0.34782608695652173,4,27,37,9,45,0,0,1,93,26.0,0,119.0
AUS,2017,June,46,30,16,0.34782608695652173,1,36,41,5,32,14,0,0,90,4.0,0,94.0
CHE,2015,September,30,30,0,0.0,7,15,17,13,18,7,3,2,52,3.0,0,55.0
RUS,2017,January,49,29,20,0.40816326530612246,4,51,45,4,42,7,0,0,90,9.0,0,99.0
POL,2015,October,29,29,0,0.0,1,20,23,6,11,12,6,0,56,2.0,1,59.0
CHN,2016,August,40,29,11,0.275,0,27,29,11,24,16,0,0,84,6.0,0,90.0
RUS,2016,October,39,29,10,0.2564102564102564,2,23,16,23,20,19,0,0,77,7.0,0,84.0
BEL,2015,December,31,29,2,0.06451612903225806,2,29,24,7,23,4,4,0,57,4.0,0,61.0
ITA,2015,November,32,29,3,0.09375,3,17,19,13,18,9,4,1,52,4.0,0,56.0
CHN,2017,July,50,28,22,0.44,0,47,43,7,47,3,0,0,102,18.0,0,120.0
BEL,2015,November,28,28,0,0.0,1,28,18,10,21,2,3,2,52,3.0,1,56.0
ISR,2016,June,42,28,14,0.3333333333333333,1,27,42,0,27,15,0,0,75,1.0,0,76.0
AUS,2017,August,33,28,5,0.15151515151515152,0,33,25,8,22,10,0,1,67,0.0,0,67.0
ISR,2016,May,34,28,6,0.17647058823529413,2,28,33,1,16,18,0,0,66,1.0,0,67.0
POL,2016,July,33,27,6,0.18181818181818182,1,20,16,17,30,2,1,0,67,4.0,0,71.0
AUT,2016,December,38,27,11,0.2894736842105263,1,36,36,2,36,2,0,0,71,10.0,0,81.0
CN,2017,April,36,27,9,0.25,4,29,29,7,25,11,0,0,71,3.0,0,74.0
SWE,2016,April,35,27,8,0.22857142857142856,3,16,27,8,31,4,0,0,64,1.0,0,65.0
RUS,2017,April,42,27,15,0.35714285714285715,3,31,31,11,34,8,0,0,77,7.0,0,84.0
FIN,2016,March,28,27,1,0.03571428571428571,5,6,12,16,24,4,0,0,54,4.0,0,58.0
ROU,2017,May,34,26,8,0.23529411764705882,2,33,14,20,22,10,2,0,65,0.0,2,67.0
CN,2016,June,32,26,6,0.1875,5,23,14,18,29,3,0,0,66,8.0,1,75.0
FIN,2016,November,28,26,2,0.07142857142857142,2,25,16,12,23,5,0,0,45,0.0,0,45.0
ROU,2016,July,33,26,7,0.21212121212121213,2,24,20,13,29,4,0,0,67,4.0,1,72.0
ISR,2015,August,26,26,0,0.0,0,16,26,0,4,22,0,0,39,0.0,0,39.0
ROU,2016,November,33,25,8,0.24242424242424243,1,36,28,5,30,3,0,0,59,9.0,0,68.0
NULL,2016,October,27,25,2,0.07407407407407407,9,12,0,27,24,3,0,0,39,0.0,0,39.0
SWE,2016,May,29,24,5,0.1724137931034483,0,16,25,4,15,14,0,0,49,1.0,0,50.0
ISR,2016,October,45,24,21,0.4666666666666667,6,58,43,2,43,2,0,0,95,11.0,0,106.0
POL,2017,May,36,24,12,0.3333333333333333,4,33,24,12,31,4,1,0,67,8.0,0,75.0
BRA,2015,July,24,24,0,0.0,3,14,9,15,11,10,3,0,47,6.0,0,53.0
NLD,2015,August,24,24,0,0.0,2,18,12,12,15,0,9,0,49,2.0,0,51.0
NULL,2016,December,32,24,8,0.25,5,23,3,29,27,4,0,1,40,1.0,2,43.0
POL,2016,May,27,24,3,0.1111111111111111,3,13,14,13,22,4,1,0,45,2.0,0,47.0
RUS,2017,July,45,24,21,0.4666666666666667,2,41,18,27,41,4,0,0,86,14.0,0,100.0
USA,2016,January,24,24,0,0.0,2,11,16,8,21,3,0,0,45,0.0,0,45.0
DNK,2015,September,24,24,0,0.0,1,4,23,1,3,20,1,0,41,0.0,0,41.0
BEL,2015,August,24,24,0,0.0,1,31,18,6,12,4,8,0,46,3.0,0,49.0
NOR,2016,August,30,24,6,0.2,1,24,27,3,28,2,0,0,59,7.0,0,66.0
ISL,2017,April,23,23,0,0.0,0,0,23,0,0,23,0,0,45,0.0,0,45.0
NLD,2016,January,25,23,2,0.08,5,18,17,8,18,6,0,1,42,0.0,0,42.0
POL,2016,January,25,23,2,0.08,3,15,11,14,24,1,0,0,47,7.0,0,54.0
SWE,2016,March,32,23,9,0.28125,1,11,28,4,28,3,1,0,59,8.0,0,67.0
AUS,2017,July,43,23,20,0.46511627906976744,0,35,33,10,36,7,0,0,86,7.0,0,93.0
USA,2016,February,28,22,6,0.21428571428571427,2,15,23,5,27,1,0,0,50,3.0,1,54.0
CHN,2017,June,42,22,20,0.47619047619047616,2,27,38,4,29,13,0,0,86,3.0,0,89.0
NULL,2017,February,22,22,0,0.0,3,13,0,22,20,2,0,0,29,2.0,0,31.0
FIN,2016,July,27,22,5,0.18518518518518517,1,26,17,10,27,0,0,0,55,7.0,0,62.0
USA,2015,August,22,22,0,0.0,3,16,4,18,20,1,1,0,41,3.0,1,45.0
FIN,2017,March,27,22,5,0.18518518518518517,1,13,18,9,23,4,0,0,48,2.0,0,50.0
ROU,2017,August,34,22,12,0.35294117647058826,1,33,18,16,30,3,1,0,72,11.0,1,84.0
SWE,2016,August,30,22,8,0.26666666666666666,1,21,26,4,29,1,0,0,63,4.0,0,67.0
DNK,2017,June,26,22,4,0.15384615384615385,2,19,18,8,20,6,0,0,48,1.0,0,49.0
BRA,2015,December,27,22,5,0.18518518518518517,1,22,20,7,19,4,3,1,51,5.0,0,56.0
POL,2017,July,37,22,15,0.40540540540540543,2,25,28,9,33,1,3,0,81,13.0,0,94.0
NOR,2016,June,29,22,7,0.2413793103448276,2,17,21,8,24,5,0,0,51,3.0,0,54.0
NULL,2016,April,24,22,2,0.08333333333333333,6,2,0,24,21,3,0,0,27,1.0,0,28.0
NULL,2015,October,38,22,16,0.42105263157894735,8,13,14,24,36,2,0,0,60,0.0,0,60.0
MAR,2017,February,23,21,2,0.08695652173913043,1,12,22,1,7,16,0,0,30,2.0,0,32.0
POL,2017,March,40,21,19,0.475,2,37,28,12,39,1,0,0,79,9.0,0,88.0
CHN,2016,December,38,21,17,0.4473684210526316,0,27,30,8,34,4,0,0,70,11.0,2,83.0
AUS,2016,September,25,21,4,0.16,3,27,22,3,23,2,0,0,44,6.0,0,50.0
CN,2016,March,26,21,5,0.19230769230769232,3,13,8,18,26,0,0,0,50,7.0,0,57.0
CHN,2016,June,35,21,14,0.4,1,28,33,2,35,0,0,0,70,5.0,0,75.0
NULL,2017,January,22,21,1,0.045454545454545456,5,13,0,22,18,3,0,1,31,0.0,0,31.0
RUS,2015,September,21,21,0,0.0,2,27,17,4,6,1,14,0,34,1.0,0,35.0
NULL,2015,December,20,20,0,0.0,3,11,0,20,20,0,0,0,26,0.0,0,26.0
FRA,2015,July,20,20,0,0.0,4,15,2,18,15,4,1,0,39,3.0,0,42.0
THA,2016,November,20,20,0,0.0,0,1,20,0,1,19,0,0,38,0.0,0,38.0
ARG,2016,May,25,20,5,0.2,3,15,13,12,15,9,1,0,44,4.0,0,48.0
NULL,2015,November,20,20,0,0.0,4,5,1,19,19,1,0,0,22,0.0,0,22.0
POL,2017,August,25,20,5,0.2,0,24,18,7,21,0,4,0,52,8.0,0,60.0
IRL,2015,November,20,20,0,0.0,1,16,5,15,17,2,1,0,37,0.0,0,37.0
ISR,2016,August,44,20,24,0.5454545454545454,0,28,43,1,34,10,0,0,98,9.0,0,107.0
CHN,2017,April,44,20,24,0.5454545454545454,1,27,41,3,41,3,0,0,87,5.0,0,92.0
FIN,2017,June,23,20,3,0.13043478260869565,2,17,16,7,20,3,0,0,43,3.0,0,46.0
AUT,2015,December,20,20,0,0.0,0,2,19,1,5,15,0,0,34,0.0,0,34.0
NULL,2016,November,22,20,2,0.09090909090909091,5,14,2,20,20,0,0,2,27,0.0,0,27.0
CHN,2016,January,23,20,3,0.13043478260869565,0,12,17,6,11,12,0,0,39,1.0,0,40.0
AUT,2017,January,24,20,4,0.16666666666666666,0,20,19,5,21,3,0,0,41,0.0,0,41.0
CHN,2016,March,40,20,20,0.5,0,9,30,10,31,9,0,0,67,2.0,0,69.0
CHE,2015,December,20,20,0,0.0,1,7,14,6,20,0,0,0,40,2.0,0,42.0
FIN,2016,April,26,20,6,0.23076923076923078,3,13,14,12,26,0,0,0,50,0.0,0,50.0
AUS,2017,January,32,19,13,0.40625,0,39,26,6,32,0,0,0,62,3.0,0,65.0
FIN,2016,June,22,19,3,0.13636363636363635,0,12,20,2,19,3,0,0,41,5.0,0,46.0
DNK,2017,August,28,19,9,0.32142857142857145,0,21,26,2,23,5,0,0,62,3.0,0,65.0
FIN,2017,July,22,19,3,0.13636363636363635,0,18,21,1,22,0,0,0,43,11.0,0,54.0
CHE,2017,January,25,19,6,0.24,1,18,19,6,24,1,0,0,43,2.0,0,45.0
NULL,2017,March,19,19,0,0.0,5,10,0,19,18,1,0,0,23,0.0,0,23.0
AGO,2015,September,19,19,0,0.0,0,15,19,0,14,3,2,0,26,7.0,0,33.0
ISR,2017,June,39,19,20,0.5128205128205128,0,31,36,3,38,1,0,0,73,5.0,0,78.0
CHE,2015,August,19,19,0,0.0,1,12,7,12,15,1,2,1,37,2.0,1,40.0
LUX,2016,October,20,19,1,0.05,1,19,18,2,13,7,0,0,33,3.0,0,36.0
AUS,2016,July,22,19,3,0.13636363636363635,0,8,17,5,20,2,0,0,42,2.0,0,44.0
CN,2015,July,19,19,0,0.0,6,19,0,19,16,3,0,0,39,6.0,0,45.0
FIN,2015,October,18,18,0,0.0,3,19,10,8,10,3,4,1,33,5.0,0,38.0
FIN,2017,February,22,18,4,0.18181818181818182,2,20,14,8,22,0,0,0,43,7.0,1,51.0
AUT,2015,September,18,18,0,0.0,2,11,14,4,13,2,3,0,34,0.0,0,34.0
ISR,2017,May,22,18,4,0.18181818181818182,2,23,20,2,21,0,0,1,44,0.0,0,44.0
NOR,2016,September,25,18,7,0.28,0,17,24,1,13,12,0,0,48,2.0,0,50.0
CHN,2016,October,63,18,45,0.7142857142857143,1,45,60,3,63,0,0,0,107,8.0,0,115.0
POL,2016,February,19,18,1,0.05263157894736842,3,12,15,4,14,5,0,0,34,3.0,0,37.0
DEU,2015,July,18,18,0,0.0,4,9,6,12,14,2,2,0,36,2.0,0,38.0
RUS,2017,June,34,18,16,0.47058823529411764,4,36,21,13,33,0,0,1,67,14.0,1,82.0
CHN,2017,August,34,17,17,0.5,0,34,34,0,31,3,0,0,66,5.0,0,71.0
AUT,2015,October,17,17,0,0.0,5,8,12,5,6,9,2,0,26,0.0,0,26.0
RUS,2016,April,28,17,11,0.39285714285714285,3,14,27,1,23,5,0,0,47,5.0,0,52.0
POL,2015,November,17,17,0,0.0,3,12,7,10,10,3,4,0,33,1.0,2,36.0
LUX,2017,August,26,17,9,0.34615384615384615,2,35,14,12,20,5,0,1,52,5.0,0,57.0
AUS,2016,August,21,17,4,0.19047619047619047,1,15,14,7,18,3,0,0,44,2.0,0,46.0
NOR,2016,May,20,17,3,0.15,1,15,15,5,17,3,0,0,38,2.0,0,40.0
POL,2015,August,17,17,0,0.0,3,17,11,6,9,1,7,0,33,2.0,0,35.0
DNK,2016,March,20,17,3,0.15,0,13,17,3,18,2,0,0,39,3.0,0,42.0
USA,2015,July,17,17,0,0.0,5,16,0,17,16,0,0,1,35,8.0,0,43.0
CHN,2016,April,40,17,23,0.575,0,22,37,3,38,2,0,0,73,0.0,0,73.0
RUS,2016,September,29,17,12,0.41379310344827586,1,25,22,7,27,2,0,0,53,6.0,0,59.0
CHE,2015,July,17,17,0,0.0,5,16,0,17,14,2,1,0,35,10.0,0,45.0
USA,2015,December,17,17,0,0.0,2,14,12,5,16,0,1,0,34,5.0,0,39.0
ISL,2016,April,17,17,0,0.0,0,3,17,0,0,17,0,0,33,0.0,0,33.0
POL,2017,February,27,17,10,0.37037037037037035,1,19,15,12,27,0,0,0,56,11.0,0,67.0
JPN,2017,August,21,17,4,0.19047619047619047,0,23,20,1,21,0,0,0,29,0.0,0,29.0
HUN,2017,March,26,17,9,0.34615384615384615,1,24,23,3,24,2,0,0,46,6.0,0,52.0
ROU,2017,June,23,17,6,0.2608695652173913,5,18,14,9,22,1,0,0,47,9.0,2,58.0
BRA,2015,November,16,16,0,0.0,2,12,8,8,14,0,2,0,30,0.0,0,30.0
DZA,2015,October,16,16,0,0.0,0,1,16,0,3,13,0,0,17,0.0,0,17.0
HUN,2017,July,22,16,6,0.2727272727272727,0,13,13,9,16,6,0,0,40,3.0,0,43.0
USA,2015,November,16,16,0,0.0,2,6,11,5,10,3,1,2,25,1.0,0,26.0
FIN,2016,January,17,16,1,0.058823529411764705,2,12,7,10,17,0,0,0,28,0.0,0,28.0
AGO,2015,August,16,16,0,0.0,0,4,16,0,11,2,3,0,23,2.0,0,25.0
CYP,2017,January,16,16,0,0.0,0,14,16,0,6,10,0,0,29,0.0,0,29.0
MAR,2016,August,38,16,22,0.5789473684210527,2,27,26,12,35,2,1,0,72,21.0,1,94.0
RUS,2016,August,36,16,20,0.5555555555555556,0,17,24,12,36,0,0,0,69,17.0,0,86.0
ITA,2015,July,65,16,49,0.7538461538461538,1,5,57,8,6,56,3,0,126,2.0,0,128.0
NOR,2017,August,24,16,8,0.3333333333333333,1,21,19,5,21,3,0,0,47,8.0,0,55.0
AGO,2017,January,45,16,29,0.6444444444444445,0,18,45,0,42,1,0,2,78,17.0,1,96.0
ARG,2017,May,22,16,6,0.2727272727272727,1,15,21,1,14,8,0,0,46,0.0,0,46.0
NLD,2015,December,16,16,0,0.0,3,16,7,9,12,0,4,0,30,0.0,0,30.0
DNK,2016,November,17,16,1,0.058823529411764705,1,19,15,2,17,0,0,0,27,0.0,0,27.0
CN,2016,November,21,16,5,0.23809523809523808,3,20,15,6,21,0,0,0,38,0.0,0,38.0
CHE,2015,November,15,15,0,0.0,3,13,8,7,9,2,3,1,27,0.0,0,27.0
POL,2016,December,17,15,2,0.11764705882352941,0,19,11,6,17,0,0,0,35,4.0,0,39.0
FIN,2017,May,20,15,5,0.25,1,21,15,5,19,1,0,0,38,0.0,1,39.0
TUR,2016,June,22,15,7,0.3181818181818182,0,3,22,0,9,13,0,0,32,2.0,0,34.0
TUR,2017,January,24,15,9,0.375,0,20,21,3,16,7,0,1,45,4.0,0,49.0
LUX,2017,June,23,15,8,0.34782608695652173,1,14,19,4,23,0,0,0,46,10.0,0,56.0
POL,2015,September,15,15,0,0.0,1,13,6,9,8,2,5,0,30,0.0,0,30.0
FIN,2016,February,15,15,0,0.0,2,5,9,6,14,1,0,0,22,8.0,0,30.0
CN,2016,April,20,15,5,0.25,2,16,15,5,19,1,0,0,42,0.0,0,42.0
MAR,2016,February,17,15,2,0.11764705882352941,0,5,17,0,8,9,0,0,26,4.0,1,31.0
CHN,2017,May,50,15,35,0.7,1,21,47,3,43,7,0,0,96,5.0,0,101.0
RUS,2017,May,34,15,19,0.5588235294117647,1,19,22,12,25,9,0,0,64,1.0,0,65.0
RUS,2016,November,19,15,4,0.21052631578947367,2,22,14,5,19,0,0,0,31,2.0,0,33.0
AUS,2016,October,15,14,1,0.06666666666666667,0,14,14,1,13,2,0,0,30,0.0,0,30.0
ISR,2016,September,20,14,6,0.3,4,25,19,1,20,0,0,0,42,4.0,0,46.0
ROU,2016,December,21,14,7,0.3333333333333333,0,14,16,5,21,0,0,0,40,1.0,0,41.0
ROU,2015,August,14,14,0,0.0,1,15,2,12,12,0,2,0,28,4.0,0,32.0
EST,2016,September,17,14,3,0.17647058823529413,0,3,5,12,17,0,0,0,35,3.0,1,39.0
RUS,2017,March,24,14,10,0.4166666666666667,1,23,18,6,23,0,0,1,52,8.0,0,60.0
NULL,2016,July,20,14,6,0.3,4,24,0,20,20,0,0,0,32,1.0,1,34.0
NOR,2017,April,51,14,37,0.7254901960784313,0,21,40,11,48,3,0,0,105,17.0,0,122.0
TWN,2017,July,17,14,3,0.17647058823529413,0,16,5,12,7,10,0,0,31,0.0,0,31.0
ISR,2016,April,18,14,4,0.2222222222222222,0,13,17,1,12,6,0,0,35,3.0,0,38.0
FIN,2016,October,21,14,7,0.3333333333333333,1,23,12,9,19,2,0,0,39,11.0,1,51.0
BRA,2015,August,14,14,0,0.0,2,10,5,9,13,0,1,0,29,2.0,0,31.0
DNK,2017,February,20,14,6,0.3,3,6,13,7,17,3,0,0,40,6.0,0,46.0
TUR,2016,March,20,14,6,0.3,0,10,20,0,12,8,0,0,38,1.0,0,39.0
ISR,2016,March,15,14,1,0.06666666666666667,0,4,15,0,3,12,0,0,28,0.0,0,28.0
NLD,2015,July,14,14,0,0.0,1,11,1,13,11,0,3,0,27,2.0,0,29.0
CN,2015,October,26,14,12,0.46153846153846156,1,9,10,16,24,2,0,0,47,0.0,0,47.0
NULL,2015,September,30,14,16,0.5333333333333333,6,13,0,30,15,15,0,0,50,3.0,1,54.0
NOR,2015,September,14,14,0,0.0,1,14,11,3,11,2,1,0,23,3.0,0,26.0
LUX,2016,March,15,13,2,0.13333333333333333,0,4,6,9,5,10,0,0,28,2.0,0,30.0
DNK,2016,June,17,13,4,0.23529411764705882,1,9,12,5,12,5,0,0,35,4.0,0,39.0
FIN,2016,December,17,13,4,0.23529411764705882,1,13,11,6,17,0,0,0,31,3.0,0,34.0
TUR,2015,October,13,13,0,0.0,0,8,11,2,0,12,1,0,25,0.0,0,25.0
ROU,2016,June,16,13,3,0.1875,1,12,9,7,15,1,0,0,30,3.0,0,33.0
TUR,2016,May,19,13,6,0.3157894736842105,0,4,19,0,17,2,0,0,33,0.0,0,33.0
NULL,2015,July,13,13,0,0.0,5,14,0,13,12,1,0,0,21,0.0,0,21.0
LUX,2016,August,18,13,5,0.2777777777777778,2,13,13,5,17,1,0,0,35,12.0,0,47.0
AUT,2017,February,16,13,3,0.1875,0,15,14,2,16,0,0,0,24,1.0,0,25.0
UKR,2016,November,16,13,3,0.1875,0,13,4,12,4,12,0,0,30,0.0,0,30.0
CHN,2016,May,35,13,22,0.6285714285714286,0,18,31,4,32,3,0,0,64,6.0,0,70.0
ISR,2017,July,20,13,7,0.35,1,38,15,5,20,0,0,0,44,4.0,0,48.0
ROU,2016,October,26,13,13,0.5,1,34,22,4,22,4,0,0,47,0.0,0,47.0
LUX,2017,July,26,13,13,0.5,4,17,13,13,23,3,0,0,53,14.0,0,67.0
ROU,2016,September,16,13,3,0.1875,1,10,12,4,13,3,0,0,29,0.0,2,31.0
ROU,2017,April,17,13,4,0.23529411764705882,0,11,17,0,16,1,0,0,30,3.0,0,33.0
ARG,2016,June,17,13,4,0.23529411764705882,3,10,11,6,13,4,0,0,34,4.0,0,38.0
DNK,2017,April,23,13,10,0.43478260869565216,2,24,20,3,22,1,0,0,48,1.0,0,49.0
LUX,2015,September,13,13,0,0.0,1,2,12,1,2,10,1,0,23,1.0,0,24.0
NULL,2015,August,12,12,0,0.0,3,14,0,12,10,2,0,0,25,1.0,0,26.0
NULL,2016,May,12,12,0,0.0,3,2,0,12,11,1,0,0,14,0.0,0,14.0
AGO,2017,March,17,12,5,0.29411764705882354,0,12,16,1,17,0,0,0,28,0.0,2,30.0
GRC,2015,September,12,12,0,0.0,0,5,12,0,2,8,2,0,20,0.0,0,20.0
DNK,2016,October,24,12,12,0.5,0,16,23,1,16,8,0,0,47,0.0,0,47.0
NOR,2016,October,36,12,24,0.6666666666666666,0,10,34,2,36,0,0,0,69,9.0,0,78.0
IRN,2016,September,13,12,1,0.07692307692307693,0,3,13,0,12,1,0,0,27,1.0,0,28.0
DNK,2017,March,23,12,11,0.4782608695652174,0,12,21,2,23,0,0,0,43,7.0,1,51.0
AUS,2016,April,12,12,0,0.0,3,10,8,4,10,1,1,0,23,6.0,0,29.0
MOZ,2017,May,13,12,1,0.07692307692307693,0,2,13,0,3,10,0,0,28,0.0,0,28.0
MEX,2017,August,12,12,0,0.0,0,9,12,0,3,9,0,0,21,0.0,0,21.0
DNK,2016,May,13,12,1,0.07692307692307693,1,10,13,0,10,3,0,0,25,0.0,1,26.0
DZA,2016,March,14,12,2,0.14285714285714285,0,0,14,0,2,12,0,0,22,2.0,0,24.0
AUS,2017,April,17,12,5,0.29411764705882354,2,9,11,6,11,5,0,1,31,0.0,1,32.0
AGO,2016,January,30,12,18,0.6,0,9,30,0,30,0,0,0,47,2.0,0,49.0
RUS,2017,August,37,12,25,0.6756756756756757,1,28,24,13,37,0,0,0,77,6.0,0,83.0
ROU,2016,April,15,12,3,0.2,4,8,7,8,15,0,0,0,28,2.0,0,30.0
CHE,2016,January,12,11,1,0.08333333333333333,2,5,10,2,11,0,1,0,22,0.0,0,22.0
HUN,2016,June,11,11,0,0.0,1,8,10,1,6,5,0,0,16,3.0,1,20.0
RUS,2016,June,20,11,9,0.45,1,5,15,5,13,7,0,0,32,1.0,0,33.0
DNK,2016,August,12,11,1,0.08333333333333333,0,11,10,2,12,0,0,0,27,2.0,0,29.0
NULL,2016,September,11,11,0,0.0,5,5,0,11,11,0,0,0,19,0.0,0,19.0
ROU,2017,February,24,11,13,0.5416666666666666,0,24,20,4,23,1,0,0,44,1.0,0,45.0
SWE,2017,February,12,11,1,0.08333333333333333,0,7,6,6,12,0,0,0,22,4.0,1,27.0
HRV,2016,November,11,11,0,0.0,1,7,11,0,11,0,0,0,15,0.0,0,15.0
ISR,2017,August,21,11,10,0.47619047619047616,0,11,20,1,18,3,0,0,46,9.0,0,55.0
ROU,2016,May,13,11,2,0.15384615384615385,1,9,7,6,9,4,0,0,23,0.0,1,24.0
NULL,2016,June,12,11,1,0.08333333333333333,3,2,0,12,12,0,0,0,15,0.0,0,15.0
RUS,2017,February,14,11,3,0.21428571428571427,0,15,12,2,13,0,0,1,29,4.0,0,33.0
IND,2016,November,17,11,6,0.35294117647058826,0,12,16,1,16,1,0,0,32,0.0,0,32.0
JPN,2017,January,11,11,0,0.0,0,4,10,1,10,0,0,1,19,6.0,1,26.0
ARG,2017,June,18,11,7,0.3888888888888889,3,15,11,7,16,2,0,0,37,3.0,0,40.0
ROU,2015,July,11,11,0,0.0,4,16,1,10,9,2,0,0,23,3.0,0,26.0
AUS,2016,June,18,11,7,0.3888888888888889,1,11,16,2,18,0,0,0,35,1.0,0,36.0
FIN,2016,September,13,11,2,0.15384615384615385,1,17,13,0,12,1,0,0,24,2.0,3,29.0
SWE,2017,January,16,11,5,0.3125,1,7,13,3,13,3,0,0,32,3.0,1,36.0
ISR,2016,November,15,11,4,0.26666666666666666,0,20,14,1,15,0,0,0,19,4.0,0,23.0
AGO,2017,April,13,11,2,0.15384615384615385,3,13,10,3,13,0,0,0,19,1.0,0,20.0
CN,2017,February,19,11,8,0.42105263157894735,4,14,6,13,19,0,0,0,36,0.0,0,36.0
CHN,2015,December,11,11,0,0.0,0,7,7,4,8,1,2,0,22,1.0,0,23.0
CZE,2015,October,10,10,0,0.0,0,11,10,0,7,0,3,0,15,0.0,0,15.0
CHN,2015,September,10,10,0,0.0,0,13,9,1,6,0,4,0,19,0.0,0,19.0
NOR,2015,October,10,10,0,0.0,0,14,9,1,7,0,3,0,17,0.0,0,17.0
SWE,2016,February,10,10,0,0.0,1,7,4,6,9,0,0,1,20,2.0,0,22.0
AUT,2016,November,12,10,2,0.16666666666666666,0,12,8,4,7,5,0,0,23,2.0,0,25.0
POL,2015,December,10,10,0,0.0,0,9,5,5,7,2,1,0,21,5.0,0,26.0
BOL,2016,May,10,10,0,0.0,0,0,10,0,0,10,0,0,18,0.0,0,18.0
ARG,2017,January,15,10,5,0.3333333333333333,5,17,11,4,14,0,0,1,35,3.0,0,38.0
AUS,2015,September,10,10,0,0.0,1,9,7,3,5,0,5,0,19,1.0,0,20.0
ROU,2016,March,10,10,0,0.0,2,6,7,3,8,2,0,0,21,1.0,0,22.0
ROU,2015,October,10,10,0,0.0,0,5,9,1,2,6,2,0,14,1.0,0,15.0
NULL,2017,April,20,10,10,0.5,1,7,4,16,18,1,0,1,24,0.0,0,24.0
IND,2015,November,10,10,0,0.0,0,3,10,0,0,9,1,0,12,0.0,0,12.0
LTU,2016,November,10,10,0,0.0,1,7,7,3,7,3,0,0,17,0.0,0,17.0
JPN,2016,July,12,10,2,0.16666666666666666,1,14,12,0,12,0,0,0,25,4.0,0,29.0
ROU,2015,September,10,10,0,0.0,1,16,8,2,7,0,3,0,20,0.0,0,20.0
JPN,2017,February,11,10,1,0.09090909090909091,0,8,10,1,11,0,0,0,19,1.0,0,20.0
FIN,2016,August,12,10,2,0.16666666666666666,0,8,12,0,6,6,0,0,26,0.0,0,26.0
JPN,2017,June,11,10,1,0.09090909090909091,0,18,10,1,11,0,0,0,15,2.0,0,17.0
CN,2016,February,12,10,2,0.16666666666666666,1,9,8,4,11,1,0,0,18,0.0,0,18.0
NOR,2016,March,10,10,0,0.0,0,3,7,3,8,0,0,2,15,0.0,0,15.0
JPN,2016,March,11,10,1,0.09090909090909091,0,10,11,0,6,5,0,0,15,3.0,0,18.0
IND,2017,April,14,10,4,0.2857142857142857,1,15,7,7,12,2,0,0,28,10.0,0,38.0
HUN,2017,June,13,10,3,0.23076923076923078,1,13,8,5,9,4,0,0,25,4.0,0,29.0
JPN,2016,December,12,10,2,0.16666666666666666,1,14,12,0,12,0,0,0,23,3.0,0,26.0
AUS,2016,May,13,10,3,0.23076923076923078,1,4,10,3,11,2,0,0,24,2.0,0,26.0
LVA,2015,September,9,9,0,0.0,2,9,0,9,8,0,1,0,14,1.0,0,15.0
MAR,2016,April,9,9,0,0.0,3,5,8,1,5,4,0,0,17,1.0,0,18.0
MAR,2017,August,33,9,24,0.7272727272727273,1,27,16,17,30,3,0,0,65,21.0,0,86.0
LUX,2017,March,14,9,5,0.35714285714285715,0,11,13,1,14,0,0,0,27,1.0,1,29.0
MAR,2015,August,9,9,0,0.0,1,10,6,3,6,0,3,0,17,2.0,1,20.0
AUS,2016,November,10,9,1,0.1,2,7,6,4,10,0,0,0,22,0.0,0,22.0
CN,2016,January,9,9,0,0.0,1,4,4,5,9,0,0,0,16,0.0,0,16.0
IND,2016,April,10,9,1,0.1,0,4,7,3,9,0,0,1,18,1.0,0,19.0
ROU,2016,January,10,9,1,0.1,0,5,10,0,4,5,1,0,18,0.0,0,18.0
NOR,2017,January,11,9,2,0.18181818181818182,0,6,11,0,9,2,0,0,18,1.0,0,19.0
LTU,2016,September,9,9,0,0.0,0,5,0,9,9,0,0,0,18,0.0,0,18.0
ARG,2016,April,13,9,4,0.3076923076923077,4,6,11,2,13,0,0,0,26,0.0,0,26.0
FIN,2015,November,9,9,0,0.0,1,7,3,6,8,1,0,0,17,0.0,0,17.0
DNK,2017,May,25,9,16,0.64,0,12,24,1,23,2,0,0,42,14.0,0,56.0
ROU,2017,March,17,9,8,0.47058823529411764,0,15,14,3,17,0,0,0,29,6.0,0,35.0
ISR,2015,September,9,9,0,0.0,0,9,9,0,5,0,4,0,19,0.0,1,20.0
RUS,2016,January,9,9,0,0.0,2,4,6,3,4,5,0,0,15,2.0,0,17.0
ZAF,2017,July,9,9,0,0.0,1,10,4,5,4,5,0,0,17,5.0,0,22.0
NOR,2015,July,9,9,0,0.0,0,10,0,9,5,2,2,0,19,1.0,1,21.0
NZL,2016,May,9,9,0,0.0,0,0,9,0,0,9,0,0,14,0.0,0,14.0
LUX,2017,May,20,9,11,0.55,0,20,20,0,20,0,0,0,40,0.0,0,40.0
RUS,2016,July,22,9,13,0.5909090909090909,0,10,18,4,22,0,0,0,46,5.0,0,51.0
CN,2015,August,9,9,0,0.0,1,4,1,8,8,0,1,0,18,5.0,0,23.0
JPN,2016,September,11,9,2,0.18181818181818182,0,9,11,0,10,1,0,0,22,1.0,0,23.0
LUX,2017,April,16,8,8,0.5,0,12,14,2,16,0,0,0,31,3.0,0,34.0
KOR,2017,January,16,8,8,0.5,0,9,16,0,16,0,0,0,35,0.0,0,35.0
DNK,2017,January,8,8,0,0.0,0,4,7,1,6,2,0,0,14,0.0,0,14.0
CZE,2015,September,8,8,0,0.0,0,1,3,5,0,6,2,0,15,0.0,0,15.0
TUR,2016,October,9,8,1,0.1111111111111111,0,11,9,0,8,0,0,1,16,0.0,0,16.0
BEL,2015,July,8,8,0,0.0,2,9,0,8,8,0,0,0,16,3.0,0,19.0
DNK,2016,February,8,8,0,0.0,0,6,7,1,5,1,0,2,13,2.0,0,15.0
NULL,2016,August,9,8,1,0.1111111111111111,4,11,0,9,9,0,0,0,17,3.0,0,20.0
SWE,2015,July,8,8,0,0.0,1,12,1,7,8,0,0,0,16,3.0,0,19.0
GRC,2016,January,8,8,0,0.0,0,8,3,5,7,1,0,0,9,0.0,0,9.0
ARG,2017,April,9,8,1,0.1111111111111111,0,8,7,2,8,1,0,0,16,0.0,0,16.0
MAR,2017,January,11,8,3,0.2727272727272727,3,4,8,3,10,1,0,0,20,5.0,0,25.0
LVA,2016,November,9,8,1,0.1111111111111111,0,11,3,6,6,3,0,0,14,0.0,0,14.0
MYS,2016,December,8,8,0,0.0,0,6,2,6,8,0,0,0,15,3.0,0,18.0
DNK,2016,September,11,8,3,0.2727272727272727,1,11,9,2,11,0,0,0,23,2.0,0,25.0
CZE,2017,July,9,8,1,0.1111111111111111,0,9,8,1,9,0,0,0,20,0.0,0,20.0
RUS,2015,November,8,8,0,0.0,2,5,1,7,5,2,1,0,15,2.0,0,17.0
HUN,2016,October,15,8,7,0.4666666666666667,0,13,14,1,15,0,0,0,30,1.0,0,31.0
IND,2017,May,11,8,3,0.2727272727272727,2,4,6,5,11,0,0,0,21,3.0,0,24.0
CZE,2016,September,10,8,2,0.2,1,6,9,1,9,1,0,0,19,2.0,0,21.0
HUN,2015,October,8,8,0,0.0,1,7,7,1,5,0,3,0,12,0.0,0,12.0
CZE,2015,November,8,8,0,0.0,0,1,3,5,3,5,0,0,12,0.0,0,12.0
ISR,2016,July,23,8,15,0.6521739130434783,3,19,20,3,23,0,0,0,50,2.0,0,52.0
HUN,2017,August,10,8,2,0.2,1,15,6,4,7,2,1,0,19,2.0,0,21.0
DNK,2016,December,11,8,3,0.2727272727272727,0,8,9,2,9,2,0,0,21,0.0,0,21.0
NOR,2015,August,8,8,0,0.0,1,9,4,4,5,0,3,0,15,2.0,0,17.0
JPN,2016,June,11,8,3,0.2727272727272727,0,10,11,0,9,2,0,0,24,0.0,0,24.0
RUS,2015,December,8,8,0,0.0,2,8,4,4,5,0,3,0,14,0.0,0,14.0
JPN,2015,December,8,8,0,0.0,2,6,6,2,4,2,2,0,16,2.0,0,18.0
IRN,2015,September,9,8,1,0.1111111111111111,0,0,9,0,1,7,1,0,12,0.0,0,12.0
AUS,2016,March,8,8,0,0.0,0,7,6,2,8,0,0,0,14,2.0,0,16.0
ARG,2017,July,10,7,3,0.3,0,11,9,1,8,2,0,0,21,1.0,0,22.0
MEX,2017,May,9,7,2,0.2222222222222222,0,5,9,0,8,1,0,0,15,0.0,0,15.0
MKD,2016,November,7,7,0,0.0,0,3,7,0,7,0,0,0,7,0.0,0,7.0
RUS,2015,October,7,7,0,0.0,0,8,6,1,5,0,2,0,12,0.0,0,12.0
CN,2016,December,10,7,3,0.3,0,13,4,6,10,0,0,0,20,0.0,0,20.0
HUN,2016,March,12,7,5,0.4166666666666667,0,5,12,0,10,2,0,0,24,0.0,0,24.0
AGO,2016,November,24,7,17,0.7083333333333334,0,16,24,0,24,0,0,0,34,7.0,0,41.0
GRC,2017,May,9,7,2,0.2222222222222222,0,9,9,0,9,0,0,0,13,0.0,0,13.0
MAR,2016,January,10,7,3,0.3,1,2,6,4,5,4,0,1,23,0.0,0,23.0
FIN,2016,May,12,7,5,0.4166666666666667,1,13,10,2,12,0,0,0,25,4.0,0,29.0
HUN,2016,November,19,7,12,0.631578947368421,0,24,19,0,17,2,0,0,33,0.0,0,33.0
LTU,2017,April,8,7,1,0.125,1,3,6,2,2,6,0,0,16,0.0,0,16.0
HUN,2016,February,8,7,1,0.125,1,7,7,1,6,2,0,0,16,1.0,0,17.0
RUS,2016,May,13,7,6,0.46153846153846156,1,4,12,1,11,2,0,0,21,4.0,0,25.0
CYP,2016,November,8,7,1,0.125,0,8,8,0,8,0,0,0,8,0.0,0,8.0
RUS,2016,March,18,7,11,0.6111111111111112,0,10,17,1,16,2,0,0,34,0.0,0,34.0
NZL,2016,June,9,7,2,0.2222222222222222,0,8,9,0,9,0,0,0,17,0.0,0,17.0
CZE,2017,May,10,7,3,0.3,1,6,9,1,10,0,0,0,20,2.0,1,23.0
SWE,2015,November,7,7,0,0.0,0,4,5,2,2,3,2,0,9,0.0,0,9.0
ISR,2015,November,7,7,0,0.0,0,4,7,0,6,1,0,0,10,0.0,0,10.0
NZL,2017,June,7,7,0,0.0,1,1,5,2,7,0,0,0,14,2.0,0,16.0
MAR,2017,July,20,7,13,0.65,2,27,10,10,20,0,0,0,41,9.0,0,50.0
TUR,2015,November,7,7,0,0.0,0,10,7,0,1,1,5,0,12,0.0,0,12.0
MAR,2016,September,13,7,6,0.46153846153846156,0,12,10,3,12,1,0,0,24,3.0,1,28.0
SWE,2016,January,7,7,0,0.0,2,3,4,3,7,0,0,0,14,1.0,0,15.0
HUN,2016,December,8,7,1,0.125,1,6,6,2,8,0,0,0,15,0.0,1,16.0
JPN,2015,September,7,7,0,0.0,0,5,7,0,1,3,1,2,10,0.0,0,10.0
IND,2016,May,11,7,4,0.36363636363636365,1,5,8,3,10,1,0,0,20,3.0,1,24.0
CZE,2016,November,9,7,2,0.2222222222222222,0,5,7,2,8,1,0,0,16,0.0,0,16.0
IND,2016,December,8,7,1,0.125,0,16,7,1,8,0,0,0,18,3.0,0,21.0
NOR,2016,April,9,7,2,0.2222222222222222,1,6,8,1,9,0,0,0,18,0.0,0,18.0
SVN,2016,November,8,7,1,0.125,0,11,6,2,4,4,0,0,14,2.0,0,16.0
POL,2015,July,7,7,0,0.0,2,6,0,7,6,0,1,0,14,0.0,0,14.0
DNK,2016,April,8,7,1,0.125,1,6,4,4,7,1,0,0,13,0.0,0,13.0
COL,2017,July,10,7,3,0.3,2,6,7,3,8,2,0,0,25,0.0,0,25.0
JPN,2015,October,7,7,0,0.0,0,7,7,0,5,0,2,0,9,0.0,0,9.0
AGO,2016,September,16,7,9,0.5625,1,13,16,0,16,0,0,0,26,8.0,1,35.0
KOR,2017,February,14,7,7,0.5,0,13,9,5,14,0,0,0,28,4.0,0,32.0
TUR,2016,December,11,7,4,0.36363636363636365,0,8,11,0,11,0,0,0,25,0.0,0,25.0
MOZ,2017,July,11,7,4,0.36363636363636365,0,18,11,0,11,0,0,0,20,0.0,0,20.0
LUX,2016,July,13,7,6,0.46153846153846156,3,4,5,8,13,0,0,0,25,3.0,0,28.0
ARG,2016,March,10,7,3,0.3,0,3,10,0,10,0,0,0,20,0.0,0,20.0
EST,2016,November,7,7,0,0.0,0,2,7,0,7,0,0,0,8,0.0,0,8.0
LTU,2017,January,7,7,0,0.0,0,1,6,1,2,5,0,0,9,0.0,0,9.0
TUR,2017,March,13,7,6,0.46153846153846156,0,11,13,0,12,1,0,0,23,1.0,0,24.0
EST,2016,April,8,6,2,0.25,4,3,4,4,8,0,0,0,18,1.0,0,19.0
LTU,2015,September,6,6,0,0.0,1,6,1,5,5,0,1,0,12,0.0,0,12.0
BGR,2016,April,7,6,1,0.14285714285714285,0,6,7,0,7,0,0,0,14,1.0,0,15.0
HUN,2016,September,8,6,2,0.25,3,6,5,3,8,0,0,0,17,2.0,0,19.0
IRQ,2015,October,6,6,0,0.0,0,0,6,0,3,3,0,0,6,0.0,0,6.0
ARG,2016,September,7,6,1,0.14285714285714285,0,7,7,0,6,1,0,0,14,0.0,0,14.0
RUS,2016,February,8,6,2,0.25,0,4,6,2,8,0,0,0,14,0.0,0,14.0
FIN,2015,July,6,6,0,0.0,0,5,0,6,2,0,4,0,12,0.0,1,13.0
JPN,2016,February,7,6,1,0.14285714285714285,0,5,7,0,5,2,0,0,14,2.0,0,16.0
HRV,2016,June,6,6,0,0.0,1,4,5,1,5,1,0,0,11,0.0,0,11.0
CHL,2016,February,6,6,0,0.0,1,3,5,1,2,4,0,0,11,1.0,0,12.0
FIN,2017,August,6,6,0,0.0,0,8,5,1,5,1,0,0,10,1.0,0,11.0
COL,2017,May,11,6,5,0.45454545454545453,0,5,10,1,9,2,0,0,24,0.0,0,24.0
IND,2017,July,6,6,0,0.0,1,6,5,1,6,0,0,0,13,3.0,0,16.0
RUS,2015,July,6,6,0,0.0,0,4,0,6,6,0,0,0,11,0.0,0,11.0
MAR,2016,November,12,6,6,0.5,3,12,9,3,12,0,0,0,22,4.0,0,26.0
AUT,2015,August,6,6,0,0.0,0,10,5,1,3,1,2,0,12,0.0,0,12.0
GRC,2016,November,9,6,3,0.3333333333333333,1,2,7,2,7,2,0,0,15,0.0,0,15.0
AGO,2017,February,18,6,12,0.6666666666666666,2,10,16,2,17,1,0,0,27,3.0,0,30.0
JPN,2016,August,6,6,0,0.0,0,5,6,0,6,0,0,0,12,4.0,1,17.0
AUS,2017,March,7,6,1,0.14285714285714285,1,2,6,1,7,0,0,0,13,2.0,0,15.0
COL,2016,March,9,6,3,0.3333333333333333,0,3,8,1,9,0,0,0,15,0.0,0,15.0
AGO,2016,February,34,6,28,0.8235294117647058,1,7,34,0,25,9,0,0,48,2.0,0,50.0
HUN,2015,November,6,6,0,0.0,1,8,4,2,2,4,0,0,10,0.0,0,10.0
PHL,2017,August,15,6,9,0.6,0,15,1,14,15,0,0,0,32,0.0,0,32.0
TWN,2016,November,7,6,1,0.14285714285714285,1,6,7,0,7,0,0,0,10,0.0,0,10.0
HRV,2017,January,6,6,0,0.0,0,5,6,0,5,1,0,0,11,2.0,0,13.0
HRV,2017,May,9,6,3,0.3333333333333333,0,7,7,2,9,0,0,0,17,0.0,0,17.0
ARG,2016,January,6,6,0,0.0,0,5,4,2,2,4,0,0,14,1.0,0,15.0
JPN,2016,November,6,6,0,0.0,0,5,6,0,6,0,0,0,9,0.0,0,9.0
DZA,2016,August,10,6,4,0.4,0,11,7,3,8,2,0,0,22,2.0,0,24.0
MOZ,2016,February,6,6,0,0.0,0,1,6,0,0,6,0,0,6,0.0,0,6.0
GRC,2015,October,6,6,0,0.0,0,9,6,0,4,0,2,0,8,0.0,0,8.0
CN,2015,December,6,6,0,0.0,0,1,5,1,5,0,1,0,11,0.0,0,11.0
CHN,2015,August,6,6,0,0.0,1,4,4,2,5,1,0,0,11,0.0,0,11.0
JPN,2016,October,7,6,1,0.14285714285714285,0,6,7,0,7,0,0,0,12,0.0,0,12.0
JOR,2015,November,6,6,0,0.0,0,0,6,0,0,6,0,0,9,0.0,0,9.0
URY,2017,April,7,6,1,0.14285714285714285,1,9,7,0,7,0,0,0,15,2.0,0,17.0
BGR,2016,June,6,6,0,0.0,0,2,6,0,2,4,0,0,8,1.0,0,9.0
IRN,2017,March,8,6,2,0.25,0,4,8,0,8,0,0,0,16,3.0,0,19.0
ARG,2015,October,6,6,0,0.0,2,3,3,3,3,2,1,0,11,0.0,0,11.0
GRC,2016,December,8,6,2,0.25,0,9,8,0,6,2,0,0,15,0.0,0,15.0
TUR,2017,August,9,6,3,0.3333333333333333,2,11,5,4,9,0,0,0,18,1.0,0,19.0
TUR,2016,September,15,6,9,0.6,0,2,6,9,15,0,0,0,29,4.0,0,33.0
AGO,2016,June,16,6,10,0.625,0,3,14,2,16,0,0,0,24,5.0,0,29.0
IND,2017,June,10,6,4,0.4,0,10,10,0,9,1,0,0,22,4.0,0,26.0
DNK,2015,October,6,6,0,0.0,0,1,5,1,5,1,0,0,10,0.0,0,10.0
BGR,2017,June,5,5,0,0.0,0,2,5,0,5,0,0,0,9,0.0,0,9.0
PER,2017,June,5,5,0,0.0,0,4,5,0,4,1,0,0,10,0.0,0,10.0
DZA,2015,November,5,5,0,0.0,1,0,3,2,2,3,0,0,5,0.0,0,5.0
HRV,2017,February,5,5,0,0.0,0,2,5,0,5,0,0,0,8,0.0,0,8.0
NZL,2016,July,5,5,0,0.0,1,2,5,0,5,0,0,0,11,0.0,0,11.0
HUN,2015,September,5,5,0,0.0,0,7,3,2,4,0,1,0,8,0.0,0,8.0
IRN,2016,December,5,5,0,0.0,0,6,5,0,5,0,0,0,8,1.0,0,9.0
URY,2017,May,5,5,0,0.0,0,6,5,0,5,0,0,0,10,0.0,0,10.0
DNK,2015,July,5,5,0,0.0,0,7,0,5,3,2,0,0,11,0.0,0,11.0
LUX,2016,April,9,5,4,0.4444444444444444,0,3,8,1,9,0,0,0,19,1.0,0,20.0
JPN,2017,May,7,5,2,0.2857142857142857,0,7,7,0,6,1,0,0,13,0.0,0,13.0
LUX,2015,October,5,5,0,0.0,1,8,1,4,3,2,0,0,11,0.0,0,11.0
AGO,2016,August,10,5,5,0.5,0,4,7,3,10,0,0,0,18,1.0,0,19.0
CN,2017,January,11,5,6,0.5454545454545454,2,7,2,9,11,0,0,0,19,0.0,0,19.0
CZE,2016,June,6,5,1,0.16666666666666666,0,2,6,0,3,3,0,0,11,1.0,0,12.0
CHN,2016,July,28,5,23,0.8214285714285714,0,12,27,1,28,0,0,0,58,3.0,0,61.0
SVK,2016,November,5,5,0,0.0,1,3,3,2,3,2,0,0,8,0.0,0,8.0
SWE,2015,December,5,5,0,0.0,1,5,2,3,4,0,1,0,9,0.0,0,9.0
IND,2016,October,8,5,3,0.375,1,7,7,1,8,0,0,0,14,5.0,0,19.0
DZA,2016,December,6,5,1,0.16666666666666666,0,9,6,0,6,0,0,0,12,0.0,0,12.0
SVN,2016,October,6,5,1,0.16666666666666666,1,8,6,0,6,0,0,0,12,5.0,0,17.0
HRV,2016,May,6,5,1,0.16666666666666666,0,4,6,0,4,2,0,0,12,1.0,0,13.0
BGR,2016,March,5,5,0,0.0,0,4,4,1,4,0,1,0,11,0.0,0,11.0
ROU,2017,January,12,5,7,0.5833333333333334,1,14,11,1,9,3,0,0,23,3.0,0,26.0
GRC,2017,April,6,5,1,0.16666666666666666,0,0,6,0,5,1,0,0,8,1.0,0,9.0
SVK,2016,August,5,5,0,0.0,1,4,5,0,5,0,0,0,9,0.0,0,9.0
ARG,2016,July,11,5,6,0.5454545454545454,1,1,6,5,10,1,0,0,24,8.0,0,32.0
LUX,2016,November,15,5,10,0.6666666666666666,1,18,11,4,15,0,0,0,20,1.0,0,21.0
TUR,2016,April,11,5,6,0.5454545454545454,1,3,11,0,11,0,0,0,22,3.0,0,25.0
SWE,2015,August,5,5,0,0.0,1,6,3,2,2,1,2,0,10,0.0,0,10.0
KOR,2016,January,6,5,1,0.16666666666666666,1,7,4,2,5,1,0,0,11,0.0,0,11.0
NZL,2017,April,7,5,2,0.2857142857142857,1,8,5,2,6,1,0,0,13,2.0,0,15.0
JPN,2017,July,5,5,0,0.0,0,7,4,1,4,1,0,0,10,0.0,0,10.0
NZL,2017,May,6,5,1,0.16666666666666666,0,5,4,2,4,2,0,0,12,0.0,0,12.0
IND,2015,September,5,5,0,0.0,0,5,4,1,5,0,0,0,11,2.0,0,13.0
CHN,2015,July,5,5,0,0.0,3,12,0,5,5,0,0,0,10,2.0,0,12.0
FIN,2015,December,5,5,0,0.0,2,0,2,3,5,0,0,0,9,0.0,0,9.0
HRV,2016,February,5,5,0,0.0,1,3,5,0,5,0,0,0,9,0.0,0,9.0
IND,2017,March,5,5,0,0.0,0,2,4,1,5,0,0,0,9,0.0,0,9.0
MAR,2016,May,6,5,1,0.16666666666666666,0,3,6,0,4,2,0,0,8,0.0,1,9.0
GNB,2016,March,5,5,0,0.0,0,0,5,0,2,3,0,0,6,0.0,0,6.0
NOR,2016,February,5,5,0,0.0,0,1,4,1,3,2,0,0,8,0.0,0,8.0
TUR,2016,August,14,5,9,0.6428571428571429,0,5,10,4,14,0,0,0,30,0.0,0,30.0
AUS,2015,October,5,5,0,0.0,0,4,3,2,4,0,0,1,9,0.0,0,9.0
CHL,2016,September,6,5,1,0.16666666666666666,1,5,4,2,4,2,0,0,10,4.0,0,14.0
ARG,2017,August,6,5,1,0.16666666666666666,0,0,4,2,5,1,0,0,12,2.0,0,14.0
KOR,2016,April,6,5,1,0.16666666666666666,1,4,6,0,6,0,0,0,11,1.0,0,12.0
HUN,2016,July,7,5,2,0.2857142857142857,1,4,5,2,7,0,0,0,14,2.0,0,16.0
NOR,2017,March,11,5,6,0.5454545454545454,0,6,8,3,10,1,0,0,21,0.0,0,21.0
ECU,2016,December,5,5,0,0.0,1,1,4,1,5,0,0,0,9,2.0,0,11.0
GRC,2016,April,10,5,5,0.5,0,2,10,0,7,3,0,0,16,2.0,0,18.0
SRB,2017,May,4,4,0,0.0,1,3,3,1,2,2,0,0,8,0.0,0,8.0
UKR,2016,April,4,4,0,0.0,0,4,2,2,4,0,0,0,6,0.0,0,6.0
AUS,2016,January,4,4,0,0.0,0,6,3,1,4,0,0,0,8,0.0,0,8.0
HUN,2017,February,7,4,3,0.42857142857142855,0,6,7,0,7,0,0,0,15,0.0,0,15.0
ZAF,2017,August,7,4,3,0.42857142857142855,0,5,6,1,7,0,0,0,13,0.0,0,13.0
FIN,2017,January,4,4,0,0.0,1,1,4,0,1,3,0,0,5,0.0,0,5.0
LTU,2015,October,4,4,0,0.0,1,2,1,3,4,0,0,0,7,2.0,0,9.0
GIB,2015,November,4,4,0,0.0,0,0,0,4,0,4,0,0,8,0.0,0,8.0
CZE,2017,March,6,4,2,0.3333333333333333,0,5,5,1,5,1,0,0,11,0.0,0,11.0
ISR,2017,February,6,4,2,0.3333333333333333,1,6,6,0,6,0,0,0,10,2.0,0,12.0
BGR,2017,August,4,4,0,0.0,0,2,3,1,3,1,0,0,7,0.0,0,7.0
CZE,2016,March,6,4,2,0.3333333333333333,0,1,6,0,5,1,0,0,11,0.0,0,11.0
URY,2016,June,4,4,0,0.0,3,5,1,3,4,0,0,0,8,0.0,0,8.0
KOR,2016,September,7,4,3,0.42857142857142855,0,6,7,0,7,0,0,0,13,1.0,0,14.0
AGO,2016,October,9,4,5,0.5555555555555556,1,7,8,1,9,0,0,0,15,1.0,0,16.0
KOR,2015,November,4,4,0,0.0,0,1,4,0,1,3,0,0,6,0.0,0,6.0
SVK,2017,January,4,4,0,0.0,0,0,4,0,1,3,0,0,6,0.0,0,6.0
ARG,2016,November,6,4,2,0.3333333333333333,1,5,6,0,6,0,0,0,9,2.0,0,11.0
BLR,2015,September,4,4,0,0.0,0,5,3,1,2,0,2,0,6,0.0,0,6.0
LVA,2016,September,5,4,1,0.2,1,4,2,3,5,0,0,0,10,1.0,0,11.0
MEX,2017,January,4,4,0,0.0,0,1,4,0,1,3,0,0,5,1.0,0,6.0
LBY,2016,February,4,4,0,0.0,0,0,4,0,0,4,0,0,4,0.0,0,4.0
NOR,2016,January,4,4,0,0.0,1,1,2,2,2,2,0,0,5,0.0,0,5.0
CZE,2017,April,8,4,4,0.5,0,9,7,1,7,0,1,0,18,2.0,0,20.0
EST,2016,October,6,4,2,0.3333333333333333,0,6,4,2,6,0,0,0,12,2.0,0,14.0
BRB,2016,June,4,4,0,0.0,0,0,4,0,0,4,0,0,4,0.0,0,4.0
TUR,2016,November,10,4,6,0.6,0,5,10,0,7,3,0,0,15,5.0,0,20.0
ARG,2016,August,5,4,1,0.2,0,2,3,2,3,2,0,0,10,0.0,0,10.0
ARG,2016,February,4,4,0,0.0,3,1,2,2,3,1,0,0,7,1.0,1,9.0
BGR,2016,July,6,4,2,0.3333333333333333,1,7,6,0,6,0,0,0,11,1.0,0,12.0
MLT,2016,November,5,4,1,0.2,2,3,3,2,4,1,0,0,9,0.0,0,9.0
MAR,2016,July,10,4,6,0.6,1,5,4,6,10,0,0,0,21,6.0,0,27.0
ZAF,2017,May,9,4,5,0.5555555555555556,0,1,8,1,9,0,0,0,18,2.0,0,20.0
EGY,2016,February,4,4,0,0.0,0,1,4,0,2,2,0,0,5,0.0,0,5.0
HUN,2017,January,4,4,0,0.0,0,3,4,0,4,0,0,0,11,0.0,0,11.0
CZE,2017,August,4,4,0,0.0,0,5,3,1,4,0,0,0,7,2.0,1,10.0
JPN,2016,January,4,4,0,0.0,1,5,4,0,2,1,1,0,7,3.0,0,10.0
TUR,2017,May,9,4,5,0.5555555555555556,0,3,9,0,8,1,0,0,17,2.0,0,19.0
AGO,2017,May,13,4,9,0.6923076923076923,0,7,12,1,13,0,0,0,24,7.0,1,32.0
UKR,2015,December,4,4,0,0.0,0,5,4,0,3,0,1,0,7,0.0,0,7.0
HRV,2017,April,5,4,1,0.2,0,3,4,1,3,2,0,0,8,2.0,0,10.0
NOR,2017,February,7,4,3,0.42857142857142855,0,3,5,2,7,0,0,0,16,0.0,0,16.0
AUS,2017,February,8,4,4,0.5,0,7,8,0,7,0,0,1,15,0.0,0,15.0
AUS,2015,November,4,4,0,0.0,0,3,2,2,2,1,1,0,6,2.0,0,8.0
IND,2017,February,4,4,0,0.0,0,2,3,1,4,0,0,0,8,0.0,0,8.0
AUS,2016,December,6,4,2,0.3333333333333333,0,6,6,0,4,2,0,0,11,0.0,0,11.0
EST,2017,January,5,4,1,0.2,0,8,3,2,5,0,0,0,5,0.0,0,5.0
CHL,2016,July,4,4,0,0.0,1,3,2,2,2,2,0,0,8,0.0,0,8.0
GRC,2015,November,4,4,0,0.0,1,7,3,1,0,2,2,0,6,0.0,0,6.0
NZL,2016,March,4,4,0,0.0,0,3,4,0,4,0,0,0,8,0.0,0,8.0
MEX,2017,July,4,4,0,0.0,0,6,4,0,4,0,0,0,7,4.0,0,11.0
AUS,2015,August,4,4,0,0.0,0,2,3,1,2,0,2,0,7,0.0,0,7.0
BGR,2016,December,6,4,2,0.3333333333333333,0,3,5,1,6,0,0,0,11,0.0,0,11.0
NZL,2015,September,4,4,0,0.0,2,0,4,0,0,4,0,0,6,0.0,0,6.0
DZA,2017,March,5,4,1,0.2,0,6,5,0,5,0,0,0,8,0.0,0,8.0
CRI,2015,December,4,4,0,0.0,1,3,2,2,4,0,0,0,8,0.0,0,8.0
IRN,2016,June,5,4,1,0.2,1,3,5,0,5,0,0,0,11,0.0,0,11.0
DZA,2017,April,6,4,2,0.3333333333333333,0,1,6,0,6,0,0,0,10,0.0,0,10.0
MEX,2016,July,4,4,0,0.0,0,3,4,0,4,0,0,0,9,2.0,0,11.0
JOR,2017,July,6,4,2,0.3333333333333333,0,2,6,0,6,0,0,0,10,7.0,0,17.0
IND,2016,July,8,4,4,0.5,0,4,3,5,8,0,0,0,17,4.0,0,21.0
BGR,2017,April,5,4,1,0.2,0,3,4,1,5,0,0,0,10,5.0,0,15.0
CHN,2015,October,4,4,0,0.0,0,3,4,0,2,0,2,0,7,1.0,0,8.0
MAR,2016,March,6,4,2,0.3333333333333333,0,3,6,0,5,1,0,0,13,3.0,0,16.0
GRC,2017,March,12,4,8,0.6666666666666666,0,6,12,0,12,0,0,0,23,1.0,1,25.0
IRN,2017,August,4,4,0,0.0,0,2,3,1,2,2,0,0,9,2.0,0,11.0
GRC,2016,July,5,4,1,0.2,1,3,5,0,5,0,0,0,10,0.0,0,10.0
RUS,2016,December,12,4,8,0.6666666666666666,0,5,8,4,12,0,0,0,26,0.0,0,26.0
SVN,2015,October,4,4,0,0.0,0,0,4,0,0,4,0,0,5,0.0,0,5.0
URY,2016,May,4,4,0,0.0,0,1,4,0,0,4,0,0,7,0.0,0,7.0
KOR,2017,July,6,4,2,0.3333333333333333,0,5,6,0,6,0,0,0,11,0.0,0,11.0
SGP,2016,May,4,4,0,0.0,0,5,2,2,3,1,0,0,9,0.0,0,9.0
FIN,2015,September,4,4,0,0.0,0,0,4,0,1,3,0,0,4,0.0,0,4.0
AGO,2015,October,4,4,0,0.0,0,1,3,1,1,2,1,0,9,0.0,0,9.0
MOZ,2016,August,7,4,3,0.42857142857142855,0,2,6,1,5,2,0,0,12,2.0,0,14.0
MEX,2015,November,4,4,0,0.0,0,0,3,1,0,4,0,0,6,0.0,0,6.0
CZE,2016,July,9,4,5,0.5555555555555556,0,6,7,2,9,0,0,0,15,0.0,0,15.0
CZE,2016,October,11,4,7,0.6363636363636364,1,13,8,3,11,0,0,0,17,2.0,0,19.0
GEO,2017,August,10,4,6,0.6,0,6,0,10,7,3,0,0,20,4.0,0,24.0
HUN,2017,May,8,4,4,0.5,1,7,5,3,8,0,0,0,15,0.0,0,15.0
ROU,2016,February,4,4,0,0.0,0,0,4,0,3,1,0,0,7,0.0,0,7.0
ECU,2017,March,4,4,0,0.0,0,2,3,1,4,0,0,0,6,1.0,0,7.0
LUX,2016,June,7,4,3,0.42857142857142855,1,3,6,1,7,0,0,0,14,1.0,0,15.0
JPN,2016,May,8,4,4,0.5,0,3,7,1,8,0,0,0,11,0.0,0,11.0
MEX,2015,August,4,4,0,0.0,0,2,3,1,1,2,1,0,6,0.0,0,6.0
LUX,2015,August,4,4,0,0.0,2,6,1,3,3,1,0,0,9,1.0,0,10.0
AGO,2015,November,5,4,1,0.2,0,3,5,0,4,0,1,0,6,0.0,0,6.0
CHL,2015,November,4,4,0,0.0,1,3,3,1,2,1,1,0,8,0.0,0,8.0
COL,2017,June,4,4,0,0.0,0,2,3,1,2,2,0,0,7,0.0,0,7.0
PAN,2017,January,4,4,0,0.0,0,1,4,0,4,0,0,0,9,0.0,0,9.0
NOR,2015,November,4,4,0,0.0,0,2,2,2,2,2,0,0,5,0.0,0,5.0
HRV,2016,December,3,3,0,0.0,1,2,2,1,3,0,0,0,6,0.0,0,6.0
KOR,2016,June,10,3,7,0.7,2,2,9,1,10,0,0,0,21,0.0,0,21.0
GRC,2017,June,3,3,0,0.0,0,3,3,0,3,0,0,0,6,0.0,0,6.0
DZA,2016,October,6,3,3,0.5,0,4,4,2,5,1,0,0,11,2.0,0,13.0
MEX,2016,December,4,3,1,0.25,0,5,4,0,4,0,0,0,8,0.0,0,8.0
AUT,2015,July,3,3,0,0.0,1,6,0,3,3,0,0,0,7,2.0,0,9.0
MAR,2015,December,3,3,0,0.0,1,3,1,2,3,0,0,0,6,0.0,1,7.0
SVK,2016,December,18,3,15,0.8333333333333334,1,3,17,1,18,0,0,0,36,0.0,0,36.0
UKR,2015,September,3,3,0,0.0,0,5,2,1,2,0,1,0,6,2.0,0,8.0
ARE,2016,July,9,3,6,0.6666666666666666,1,2,5,4,8,1,0,0,17,2.0,0,19.0
BGR,2017,May,4,3,1,0.25,0,5,4,0,4,0,0,0,7,1.0,0,8.0
SGP,2016,December,6,3,3,0.5,0,1,5,1,6,0,0,0,12,1.0,0,13.0
SRB,2016,October,3,3,0,0.0,0,3,2,1,2,1,0,0,6,2.0,0,8.0
MYS,2015,October,3,3,0,0.0,0,6,2,1,2,0,1,0,5,1.0,0,6.0
ISR,2015,July,3,3,0,0.0,0,4,0,3,3,0,0,0,6,0.0,0,6.0
COL,2017,August,3,3,0,0.0,0,4,2,1,1,2,0,0,6,0.0,1,7.0
COL,2016,February,3,3,0,0.0,0,3,3,0,2,1,0,0,6,4.0,0,10.0
EST,2017,February,3,3,0,0.0,0,2,3,0,3,0,0,0,5,0.0,0,5.0
LBN,2015,October,3,3,0,0.0,0,2,3,0,1,1,1,0,5,0.0,0,5.0
CPV,2016,October,3,3,0,0.0,0,0,2,1,1,2,0,0,4,0.0,0,4.0
AGO,2017,June,7,3,4,0.5714285714285714,1,2,6,1,7,0,0,0,11,0.0,0,11.0
LBY,2016,March,3,3,0,0.0,0,0,3,0,2,1,0,0,3,0.0,0,3.0
LVA,2016,December,3,3,0,0.0,0,2,1,2,3,0,0,0,7,1.0,0,8.0
EGY,2016,June,3,3,0,0.0,0,5,3,0,3,0,0,0,6,2.0,0,8.0
LUX,2015,July,3,3,0,0.0,2,5,0,3,3,0,0,0,7,1.0,0,8.0
SVN,2016,June,3,3,0,0.0,0,0,3,0,0,3,0,0,3,0.0,0,3.0
HRV,2017,June,12,3,9,0.75,1,8,11,1,12,0,0,0,24,3.0,0,27.0
MAR,2016,December,9,3,6,0.6666666666666666,0,7,5,4,9,0,0,0,14,2.0,0,16.0
HUN,2017,April,11,3,8,0.7272727272727273,0,11,6,5,11,0,0,0,23,8.0,0,31.0
UKR,2016,January,4,3,1,0.25,1,3,1,3,4,0,0,0,7,0.0,0,7.0
ALB,2017,January,3,3,0,0.0,0,5,3,0,0,3,0,0,5,0.0,0,5.0
IND,2015,October,3,3,0,0.0,1,9,2,1,3,0,0,0,4,0.0,0,4.0
HUN,2016,August,8,3,5,0.625,1,5,8,0,8,0,0,0,16,2.0,0,18.0
ARG,2017,March,5,3,2,0.4,1,4,5,0,5,0,0,0,8,0.0,0,8.0
MEX,2016,March,6,3,3,0.5,0,3,6,0,6,0,0,0,10,2.0,0,12.0
MEX,2015,October,3,3,0,0.0,0,3,2,1,1,0,2,0,4,0.0,0,4.0
VEN,2015,October,3,3,0,0.0,0,4,3,0,1,0,2,0,5,0.0,0,5.0
EST,2017,June,3,3,0,0.0,0,2,3,0,3,0,0,0,6,0.0,0,6.0
ZAF,2016,June,5,3,2,0.4,1,7,5,0,5,0,0,0,10,6.0,0,16.0
MEX,2015,December,3,3,0,0.0,0,1,3,0,3,0,0,0,6,0.0,0,6.0
KOR,2016,May,7,3,4,0.5714285714285714,0,5,7,0,7,0,0,0,14,0.0,0,14.0
SGP,2016,November,3,3,0,0.0,0,4,3,0,3,0,0,0,4,0.0,0,4.0
HUN,2016,May,6,3,3,0.5,0,4,6,0,6,0,0,0,13,0.0,0,13.0
EGY,2016,January,3,3,0,0.0,0,1,3,0,1,2,0,0,4,0.0,0,4.0
KOR,2017,June,6,3,3,0.5,0,2,6,0,6,0,0,0,11,0.0,0,11.0
LUX,2016,May,4,3,1,0.25,0,3,4,0,4,0,0,0,8,0.0,0,8.0
ZAF,2016,January,6,3,3,0.5,0,2,5,1,6,0,0,0,9,0.0,0,9.0
ZAF,2017,June,4,3,1,0.25,0,2,4,0,3,0,0,1,8,2.0,0,10.0
IND,2016,January,3,3,0,0.0,0,2,2,1,2,1,0,0,5,0.0,0,5.0
TUR,2017,June,4,3,1,0.25,0,0,4,0,2,2,0,0,4,0.0,0,4.0
BLR,2015,November,3,3,0,0.0,0,2,2,1,2,0,1,0,4,0.0,0,4.0
LVA,2017,April,3,3,0,0.0,1,1,2,1,3,0,0,0,6,0.0,0,6.0
LUX,2015,December,3,3,0,0.0,0,3,3,0,2,0,1,0,6,2.0,0,8.0
DZA,2017,May,4,3,1,0.25,0,6,4,0,4,0,0,0,8,1.0,0,9.0
IND,2017,January,3,3,0,0.0,0,1,2,1,1,2,0,0,4,1.0,0,5.0
SAU,2017,July,3,3,0,0.0,0,4,3,0,3,0,0,0,8,1.0,0,9.0
IND,2016,March,3,3,0,0.0,0,3,2,1,2,1,0,0,5,1.0,0,6.0
KOR,2016,November,5,3,2,0.4,0,4,5,0,5,0,0,0,10,0.0,0,10.0
EST,2017,July,4,3,1,0.25,0,0,2,2,4,0,0,0,10,1.0,0,11.0
ISL,2017,January,3,3,0,0.0,0,2,1,2,3,0,0,0,4,0.0,0,4.0
NZL,2016,September,3,3,0,0.0,0,3,2,1,2,1,0,0,6,1.0,0,7.0
BGR,2017,February,3,3,0,0.0,0,4,2,1,3,0,0,0,6,0.0,0,6.0
SVK,2017,March,3,3,0,0.0,0,1,1,2,1,2,0,0,5,0.0,0,5.0
IDN,2017,April,3,3,0,0.0,0,1,2,1,3,0,0,0,6,0.0,0,6.0
MOZ,2016,July,5,3,2,0.4,0,6,4,1,5,0,0,0,12,1.0,0,13.0
CHL,2017,August,4,3,1,0.25,1,6,1,3,4,0,0,0,8,0.0,0,8.0
ARG,2017,February,4,3,1,0.25,0,2,4,0,4,0,0,0,9,1.0,0,10.0
LVA,2017,March,4,3,1,0.25,0,3,4,0,4,0,0,0,8,0.0,0,8.0
KOR,2017,August,3,3,0,0.0,0,1,3,0,3,0,0,0,5,0.0,0,5.0
LTU,2015,December,3,3,0,0.0,0,1,0,3,3,0,0,0,6,0.0,0,6.0
GRC,2016,October,6,3,3,0.5,0,6,6,0,6,0,0,0,11,0.0,0,11.0
CN,2015,November,3,3,0,0.0,1,0,1,2,3,0,0,0,6,0.0,0,6.0
GNB,2016,February,3,3,0,0.0,0,0,3,0,0,3,0,0,3,0.0,0,3.0
SRB,2017,April,4,3,1,0.25,1,4,1,3,3,1,0,0,7,0.0,0,7.0
THA,2016,April,3,3,0,0.0,0,6,3,0,3,0,0,0,8,1.0,0,9.0
EST,2016,May,3,3,0,0.0,0,1,3,0,1,2,0,0,6,0.0,0,6.0
MOZ,2016,November,3,3,0,0.0,0,0,3,0,0,3,0,0,3,0.0,0,3.0
MEX,2016,May,3,3,0,0.0,1,1,2,1,2,1,0,0,6,0.0,0,6.0
CHN,2015,November,3,3,0,0.0,0,1,3,0,1,1,1,0,5,0.0,0,5.0
THA,2016,September,3,3,0,0.0,0,6,1,2,1,2,0,0,6,0.0,0,6.0
LUX,2017,February,6,3,3,0.5,1,4,5,1,6,0,0,0,13,1.0,0,14.0
KOR,2016,February,3,3,0,0.0,0,2,3,0,1,2,0,0,3,5.0,0,8.0
LVA,2015,October,3,3,0,0.0,0,2,0,3,1,2,0,0,6,0.0,0,6.0
ROU,2015,December,3,3,0,0.0,1,2,3,0,3,0,0,0,6,0.0,0,6.0
CZE,2017,June,5,3,2,0.4,1,10,3,2,5,0,0,0,10,0.0,0,10.0
JPN,2015,November,3,3,0,0.0,0,2,3,0,1,1,1,0,6,0.0,0,6.0
MOZ,2016,December,3,3,0,0.0,0,5,3,0,3,0,0,0,6,0.0,0,6.0
ROU,2015,November,3,3,0,0.0,0,0,3,0,1,2,0,0,4,0.0,0,4.0
ARG,2016,October,5,3,2,0.4,0,5,4,1,5,0,0,0,12,0.0,0,12.0
IND,2016,September,3,3,0,0.0,0,4,3,0,3,0,0,0,6,1.0,1,8.0
MEX,2016,November,3,3,0,0.0,0,2,3,0,3,0,0,0,5,0.0,0,5.0
PER,2016,January,3,3,0,0.0,0,1,3,0,1,2,0,0,5,0.0,0,5.0
CZE,2016,January,3,3,0,0.0,0,0,3,0,1,2,0,0,3,0.0,0,3.0
SVN,2015,August,3,3,0,0.0,1,4,0,3,3,0,0,0,6,4.0,0,10.0
TUR,2017,April,6,3,3,0.5,0,2,6,0,6,0,0,0,12,2.0,0,14.0
MAR,2017,June,4,3,1,0.25,0,4,3,1,3,1,0,0,8,0.0,0,8.0
TUN,2016,February,3,3,0,0.0,0,1,3,0,3,0,0,0,5,0.0,0,5.0
CRI,2016,May,3,3,0,0.0,0,1,3,0,2,1,0,0,6,1.0,0,7.0
NZL,2016,August,3,3,0,0.0,0,2,2,1,2,1,0,0,5,0.0,0,5.0
BGR,2016,October,3,3,0,0.0,0,3,3,0,3,0,0,0,5,0.0,0,5.0
ALB,2016,November,3,3,0,0.0,0,0,3,0,3,0,0,0,4,0.0,0,4.0
CYP,2017,August,3,3,0,0.0,0,3,3,0,3,0,0,0,5,1.0,0,6.0
SVK,2016,June,3,3,0,0.0,1,1,3,0,2,1,0,0,5,0.0,0,5.0
SRB,2017,July,4,3,1,0.25,0,3,4,0,4,0,0,0,10,0.0,0,10.0
AGO,2015,December,6,3,3,0.5,0,5,6,0,6,0,0,0,7,0.0,0,7.0
AUS,2016,February,12,3,9,0.75,1,1,10,2,12,0,0,0,22,0.0,0,22.0
KOR,2016,December,3,3,0,0.0,0,3,3,0,3,0,0,0,6,3.0,0,9.0
KOR,2016,October,4,3,1,0.25,0,5,4,0,4,0,0,0,6,0.0,1,7.0
MNE,2016,November,3,3,0,0.0,0,0,3,0,0,3,0,0,4,0.0,0,4.0
KAZ,2017,July,4,3,1,0.25,0,9,2,2,4,0,0,0,6,0.0,0,6.0
IRN,2016,March,9,3,6,0.6666666666666666,0,4,9,0,9,0,0,0,19,4.0,0,23.0
DZA,2017,January,4,3,1,0.25,0,1,3,1,3,1,0,0,6,0.0,0,6.0
AGO,2016,May,9,3,6,0.6666666666666666,1,3,8,1,9,0,0,0,12,4.0,0,16.0
EGY,2015,November,3,3,0,0.0,0,0,3,0,0,3,0,0,3,0.0,0,3.0
GRC,2017,July,4,3,1,0.25,1,4,3,1,4,0,0,0,9,2.0,0,11.0
TUR,2015,September,4,3,1,0.25,0,4,4,0,2,0,2,0,8,0.0,0,8.0
CHL,2016,May,3,3,0,0.0,1,2,3,0,1,2,0,0,6,0.0,0,6.0
JPN,2017,March,5,3,2,0.4,0,2,5,0,5,0,0,0,10,0.0,0,10.0
SGP,2015,December,3,3,0,0.0,0,0,3,0,0,3,0,0,7,0.0,0,7.0
CYP,2016,October,3,3,0,0.0,0,0,2,1,3,0,0,0,3,0.0,0,3.0
AUT,2016,January,3,3,0,0.0,0,0,2,1,3,0,0,0,6,0.0,0,6.0
EST,2017,April,6,3,3,0.5,0,3,5,1,6,0,0,0,14,1.0,0,15.0
KOR,2015,September,3,3,0,0.0,0,5,3,0,0,0,3,0,7,0.0,0,7.0
LTU,2016,August,3,3,0,0.0,0,3,0,3,3,0,0,0,6,0.0,0,6.0
ECU,2017,May,4,3,1,0.25,0,3,4,0,3,1,0,0,10,0.0,0,10.0
GTM,2017,January,3,3,0,0.0,0,0,3,0,3,0,0,0,6,0.0,0,6.0
JPN,2017,April,4,3,1,0.25,1,0,3,1,4,0,0,0,8,4.0,0,12.0
CHL,2016,June,4,3,1,0.25,0,1,4,0,3,1,0,0,6,0.0,0,6.0
MAR,2015,November,3,3,0,0.0,0,0,3,0,3,0,0,0,6,0.0,0,6.0
LVA,2016,April,4,3,1,0.25,0,1,2,2,3,1,0,0,9,1.0,0,10.0
IRN,2017,June,7,3,4,0.5714285714285714,1,4,6,1,6,1,0,0,13,1.0,0,14.0
ISR,2016,January,4,3,1,0.25,0,2,4,0,4,0,0,0,7,0.0,0,7.0
LTU,2017,July,4,3,1,0.25,1,5,0,4,2,2,0,0,8,0.0,0,8.0
DZA,2016,November,3,3,0,0.0,0,1,2,1,3,0,0,0,4,0.0,0,4.0
HRV,2016,August,4,3,1,0.25,0,2,4,0,4,0,0,0,10,0.0,0,10.0
AGO,2016,July,8,3,5,0.625,0,6,6,2,8,0,0,0,16,3.0,0,19.0
MEX,2015,September,3,3,0,0.0,0,3,3,0,1,0,1,1,5,0.0,0,5.0
HUN,2016,April,7,3,4,0.5714285714285714,1,1,5,2,6,1,0,0,11,0.0,0,11.0
CZE,2017,February,6,3,3,0.5,0,0,6,0,6,0,0,0,12,0.0,0,12.0
LKA,2017,March,3,3,0,0.0,0,4,3,0,3,0,0,0,3,0.0,0,3.0
LBN,2016,June,4,3,1,0.25,0,2,2,2,4,0,0,0,8,2.0,0,10.0
BLR,2016,December,3,2,1,0.3333333333333333,0,2,1,2,3,0,0,0,4,0.0,0,4.0
LVA,2017,February,4,2,2,0.5,1,5,3,1,4,0,0,0,8,0.0,0,8.0
MYS,2016,November,3,2,1,0.3333333333333333,0,2,3,0,2,1,0,0,6,0.0,0,6.0
ECU,2016,June,2,2,0,0.0,0,2,2,0,2,0,0,0,4,0.0,0,4.0
BGR,2017,January,2,2,0,0.0,0,2,2,0,2,0,0,0,2,0.0,0,2.0
UKR,2016,March,3,2,1,0.3333333333333333,0,2,3,0,3,0,0,0,6,3.0,0,9.0
THA,2016,October,6,2,4,0.6666666666666666,0,7,6,0,6,0,0,0,11,0.0,0,11.0
SAU,2015,October,2,2,0,0.0,0,0,2,0,1,0,1,0,3,1.0,0,4.0
MAR,2015,October,2,2,0,0.0,1,1,1,1,2,0,0,0,4,0.0,0,4.0
UKR,2015,November,2,2,0,0.0,0,2,0,2,2,0,0,0,4,0.0,0,4.0
SRB,2016,March,2,2,0,0.0,1,1,1,1,2,0,0,0,5,0.0,0,5.0
DZA,2016,April,3,2,1,0.3333333333333333,0,1,3,0,3,0,0,0,6,0.0,0,6.0
ZAF,2016,August,4,2,2,0.5,0,2,3,1,4,0,0,0,8,0.0,0,8.0
TUN,2016,June,3,2,1,0.3333333333333333,1,3,3,0,2,1,0,0,5,1.0,0,6.0
MAR,2017,March,5,2,3,0.6,0,3,5,0,5,0,0,0,10,1.0,0,11.0
TWN,2016,April,4,2,2,0.5,0,1,4,0,4,0,0,0,8,1.0,0,9.0
LTU,2015,November,2,2,0,0.0,0,1,0,2,2,0,0,0,3,0.0,0,3.0
IRN,2015,November,2,2,0,0.0,0,1,2,0,0,1,1,0,2,0.0,0,2.0
GRC,2016,February,2,2,0,0.0,0,1,2,0,1,1,0,0,4,0.0,0,4.0
PRI,2016,June,2,2,0,0.0,0,0,0,2,2,0,0,0,2,0.0,0,2.0
BIH,2016,April,2,2,0,0.0,0,0,2,0,2,0,0,0,3,0.0,0,3.0
GRC,2016,September,2,2,0,0.0,0,1,2,0,2,0,0,0,2,0.0,0,2.0
GRC,2017,February,2,2,0,0.0,0,0,2,0,2,0,0,0,4,0.0,0,4.0
MAR,2017,April,8,2,6,0.75,1,7,7,1,8,0,0,0,14,4.0,0,18.0
EST,2017,March,5,2,3,0.6,0,4,4,1,5,0,0,0,10,4.0,0,14.0
MEX,2017,March,2,2,0,0.0,0,0,2,0,2,0,0,0,3,0.0,0,3.0
KOR,2016,March,2,2,0,0.0,1,1,2,0,1,1,0,0,4,0.0,0,4.0
ARG,2015,September,2,2,0,0.0,0,1,1,1,1,1,0,0,3,0.0,0,3.0
CHL,2015,October,2,2,0,0.0,0,0,1,1,1,1,0,0,4,2.0,0,6.0
CHL,2017,January,3,2,1,0.3333333333333333,1,5,2,1,3,0,0,0,5,0.0,0,5.0
IRN,2016,February,2,2,0,0.0,0,0,2,0,0,2,0,0,3,0.0,0,3.0
LUX,2016,September,4,2,2,0.5,0,4,1,3,4,0,0,0,9,0.0,0,9.0
UKR,2017,June,3,2,1,0.3333333333333333,0,3,3,0,3,0,0,0,5,0.0,0,5.0
LAO,2017,August,2,2,0,0.0,0,2,2,0,2,0,0,0,4,0.0,0,4.0
EST,2016,December,2,2,0,0.0,1,1,1,1,2,0,0,0,4,1.0,0,5.0
TUR,2016,January,6,2,4,0.6666666666666666,0,3,6,0,5,1,0,0,9,1.0,0,10.0
OMN,2016,October,2,2,0,0.0,2,1,0,2,0,2,0,0,4,0.0,0,4.0
ISL,2017,July,2,2,0,0.0,2,1,0,2,2,0,0,0,5,1.0,0,6.0
LBN,2017,February,2,2,0,0.0,0,2,2,0,2,0,0,0,5,0.0,0,5.0
SVK,2016,September,2,2,0,0.0,0,2,1,1,2,0,0,0,4,0.0,1,5.0
SVK,2017,February,2,2,0,0.0,0,2,0,2,2,0,0,0,4,2.0,0,6.0
PER,2016,October,2,2,0,0.0,0,2,2,0,2,0,0,0,4,0.0,0,4.0
SRB,2017,June,2,2,0,0.0,0,0,2,0,2,0,0,0,4,0.0,0,4.0
NGA,2017,January,3,2,1,0.3333333333333333,0,1,2,1,2,0,0,1,5,0.0,0,5.0
MAR,2016,October,2,2,0,0.0,0,3,2,0,2,0,0,0,5,0.0,0,5.0
KOR,2017,March,3,2,1,0.3333333333333333,0,1,3,0,3,0,0,0,5,0.0,0,5.0
LTU,2016,October,3,2,1,0.3333333333333333,1,6,1,2,3,0,0,0,5,1.0,0,6.0
GIB,2016,June,2,2,0,0.0,1,0,0,2,0,2,0,0,4,0.0,0,4.0
IRN,2017,February,2,2,0,0.0,0,1,2,0,2,0,0,0,5,0.0,0,5.0
ZAF,2016,December,3,2,1,0.3333333333333333,0,3,1,2,3,0,0,0,5,0.0,0,5.0
CYP,2016,August,2,2,0,0.0,0,1,1,1,2,0,0,0,4,2.0,0,6.0
SVK,2015,September,2,2,0,0.0,0,1,2,0,2,0,0,0,4,0.0,0,4.0
DZA,2017,July,2,2,0,0.0,0,0,2,0,1,1,0,0,3,0.0,0,3.0
CRI,2017,March,2,2,0,0.0,0,0,2,0,2,0,0,0,3,0.0,0,3.0
LBN,2015,November,2,2,0,0.0,0,0,2,0,0,2,0,0,3,0.0,0,3.0
BGR,2016,January,2,2,0,0.0,0,0,2,0,0,2,0,0,2,0.0,0,2.0
KOR,2015,October,3,2,1,0.3333333333333333,0,0,3,0,3,0,0,0,6,0.0,0,6.0
ZAF,2017,February,2,2,0,0.0,0,5,2,0,2,0,0,0,2,0.0,0,2.0
LBN,2017,August,3,2,1,0.3333333333333333,0,5,2,1,3,0,0,0,3,0.0,0,3.0
MYS,2015,November,2,2,0,0.0,0,2,2,0,0,2,0,0,3,0.0,0,3.0
COL,2016,June,2,2,0,0.0,0,2,2,0,2,0,0,0,4,0.0,0,4.0
HRV,2017,March,3,2,1,0.3333333333333333,0,2,2,1,3,0,0,0,5,0.0,0,5.0
THA,2016,May,4,2,2,0.5,1,3,3,1,3,1,0,0,8,2.0,0,10.0
TUN,2015,September,2,2,0,0.0,0,6,2,0,2,0,0,0,4,0.0,0,4.0
IRQ,2016,January,2,2,0,0.0,0,1,2,0,0,2,0,0,4,2.0,0,6.0
IRN,2017,July,5,2,3,0.6,0,6,5,0,5,0,0,0,11,1.0,0,12.0
DZA,2015,August,2,2,0,0.0,0,2,2,0,1,0,1,0,4,0.0,0,4.0
ARG,2016,December,2,2,0,0.0,0,3,2,0,2,0,0,0,6,0.0,0,6.0
CYP,2016,September,3,2,1,0.3333333333333333,0,0,1,2,3,0,0,0,5,0.0,0,5.0
BGR,2015,August,2,2,0,0.0,0,0,2,0,2,0,0,0,3,0.0,0,3.0
GRC,2016,June,2,2,0,0.0,0,0,2,0,2,0,0,0,3,0.0,0,3.0
LBN,2016,July,2,2,0,0.0,0,3,2,0,2,0,0,0,4,1.0,0,5.0
LVA,2016,July,2,2,0,0.0,0,3,2,0,2,0,0,0,4,1.0,0,5.0
CAF,2017,February,2,2,0,0.0,0,1,0,2,1,1,0,0,3,0.0,0,3.0
PER,2016,March,2,2,0,0.0,0,1,2,0,0,2,0,0,4,0.0,0,4.0
BGR,2017,March,2,2,0,0.0,1,4,2,0,2,0,0,0,4,0.0,0,4.0
GRC,2016,August,7,2,5,0.7142857142857143,0,3,7,0,7,0,0,0,16,1.0,0,17.0
TWN,2016,March,2,2,0,0.0,0,2,2,0,2,0,0,0,5,0.0,0,5.0
SVN,2016,March,10,2,8,0.8,0,0,10,0,1,9,0,0,15,0.0,0,15.0
PER,2015,November,2,2,0,0.0,0,0,2,0,0,2,0,0,2,0.0,0,2.0
PAN,2016,November,2,2,0,0.0,0,1,2,0,2,0,0,0,3,0.0,0,3.0
KWT,2016,March,3,2,1,0.3333333333333333,0,0,3,0,3,0,0,0,6,0.0,0,6.0
ZAF,2016,April,2,2,0,0.0,0,1,2,0,2,0,0,0,4,0.0,0,4.0
IRQ,2015,November,2,2,0,0.0,0,0,2,0,0,0,2,0,4,0.0,0,4.0
DZA,2017,June,2,2,0,0.0,0,0,2,0,2,0,0,0,3,0.0,0,3.0
UKR,2017,July,3,2,1,0.3333333333333333,0,1,1,2,3,0,0,0,6,0.0,0,6.0
ZAF,2016,November,3,2,1,0.3333333333333333,0,5,3,0,3,0,0,0,6,0.0,0,6.0
LUX,2016,February,6,2,4,0.6666666666666666,1,3,6,0,4,2,0,0,11,0.0,0,11.0
CPV,2016,November,2,2,0,0.0,0,2,2,0,2,0,0,0,3,0.0,0,3.0
COL,2016,September,6,2,4,0.6666666666666666,0,7,5,1,6,0,0,0,13,0.0,0,13.0
SGP,2017,January,9,2,7,0.7777777777777778,0,6,9,0,8,0,0,1,15,0.0,0,15.0
SVK,2017,May,4,2,2,0.5,0,3,3,1,4,0,0,0,7,2.0,0,9.0
CUB,2017,May,2,2,0,0.0,0,4,0,2,2,0,0,0,4,0.0,0,4.0
KWT,2017,July,2,2,0,0.0,0,1,1,1,2,0,0,0,4,0.0,0,4.0
SRB,2015,October,2,2,0,0.0,0,3,2,0,0,0,2,0,4,0.0,0,4.0
THA,2017,January,2,2,0,0.0,0,1,2,0,2,0,0,0,3,2.0,0,5.0
CZE,2016,May,3,2,1,0.3333333333333333,0,2,3,0,2,1,0,0,5,0.0,0,5.0
TWN,2015,September,2,2,0,0.0,0,4,2,0,2,0,0,0,4,0.0,0,4.0
CIV,2016,March,2,2,0,0.0,0,2,0,2,1,0,0,1,4,0.0,0,4.0
CZE,2017,January,2,2,0,0.0,0,0,2,0,2,0,0,0,3,0.0,0,3.0
MOZ,2015,July,2,2,0,0.0,1,6,0,2,2,0,0,0,4,1.0,0,5.0
NGA,2017,May,5,2,3,0.6,0,4,3,2,5,0,0,0,7,0.0,1,8.0
AZE,2015,September,2,2,0,0.0,0,4,2,0,0,0,2,0,3,0.0,0,3.0
EGY,2016,October,2,2,0,0.0,0,1,2,0,2,0,0,0,4,0.0,0,4.0
PER,2017,January,2,2,0,0.0,0,2,2,0,2,0,0,0,4,0.0,0,4.0
TUR,2015,December,2,2,0,0.0,1,2,1,1,2,0,0,0,4,0.0,0,4.0
HRV,2017,July,2,2,0,0.0,0,3,2,0,2,0,0,0,4,2.0,0,6.0
AGO,2016,December,14,2,12,0.8571428571428571,0,6,14,0,14,0,0,0,22,3.0,0,25.0
CHL,2017,June,2,2,0,0.0,0,2,2,0,2,0,0,0,4,0.0,0,4.0
NZL,2015,November,2,2,0,0.0,0,0,2,0,1,1,0,0,2,0.0,0,2.0
VEN,2015,November,2,2,0,0.0,1,4,0,2,2,0,0,0,4,0.0,0,4.0
NGA,2017,February,2,2,0,0.0,0,0,2,0,2,0,0,0,4,0.0,0,4.0
CRI,2017,April,2,2,0,0.0,0,1,2,0,2,0,0,0,4,0.0,0,4.0
HRV,2015,November,2,2,0,0.0,0,1,2,0,1,1,0,0,3,0.0,0,3.0
MOZ,2016,January,3,2,1,0.3333333333333333,0,0,3,0,1,2,0,0,3,0.0,0,3.0
BGR,2016,November,2,2,0,0.0,1,1,2,0,2,0,0,0,4,0.0,0,4.0
TUN,2017,January,2,2,0,0.0,0,1,2,0,2,0,0,0,4,0.0,0,4.0
ARE,2016,April,8,2,6,0.75,0,5,7,1,8,0,0,0,13,2.0,0,15.0
MOZ,2015,August,3,2,1,0.3333333333333333,0,0,3,0,3,0,0,0,6,0.0,0,6.0
KOR,2017,April,3,2,1,0.3333333333333333,0,3,3,0,3,0,0,0,5,0.0,0,5.0
ECU,2017,August,3,2,1,0.3333333333333333,0,6,3,0,3,0,0,0,6,3.0,0,9.0
MOZ,2016,March,2,2,0,0.0,0,0,2,0,2,0,0,0,3,0.0,0,3.0
PHL,2017,June,6,2,4,0.6666666666666666,0,3,5,1,6,0,0,0,14,0.0,0,14.0
GEO,2016,August,6,2,4,0.6666666666666666,0,1,6,0,6,0,0,0,13,0.0,0,13.0
CMR,2017,July,2,2,0,0.0,0,3,2,0,2,0,0,0,4,1.0,0,5.0
LTU,2016,July,2,2,0,0.0,0,2,1,1,2,0,0,0,4,0.0,0,4.0
ZAF,2016,September,2,2,0,0.0,0,0,2,0,1,1,0,0,4,0.0,0,4.0
AUS,2015,December,2,2,0,0.0,0,1,0,2,1,1,0,0,4,0.0,0,4.0
PER,2017,May,2,2,0,0.0,0,3,2,0,1,1,0,0,3,0.0,0,3.0
CHL,2017,February,4,2,2,0.5,1,4,0,4,2,2,0,0,10,1.0,0,11.0
LUX,2015,November,2,2,0,0.0,0,2,1,1,1,1,0,0,4,0.0,0,4.0
PER,2016,September,2,2,0,0.0,1,0,1,1,1,1,0,0,4,1.0,0,5.0
CHL,2016,March,3,2,1,0.3333333333333333,0,1,3,0,3,0,0,0,7,0.0,0,7.0
COL,2016,January,2,2,0,0.0,2,0,1,1,0,1,0,1,4,0.0,0,4.0
MEX,2016,September,4,2,2,0.5,0,6,4,0,4,0,0,0,9,0.0,0,9.0
DNK,2015,August,2,2,0,0.0,0,3,1,1,2,0,0,0,4,2.0,0,6.0
TUR,2016,February,7,2,5,0.7142857142857143,0,3,7,0,7,0,0,0,11,0.0,0,11.0
MLT,2016,July,2,2,0,0.0,0,0,2,0,0,2,0,0,2,0.0,0,2.0
AGO,2016,March,10,2,8,0.8,0,3,10,0,10,0,0,0,17,0.0,0,17.0
EST,2016,August,3,2,1,0.3333333333333333,0,4,3,0,3,0,0,0,6,0.0,0,6.0
BIH,2016,October,3,2,1,0.3333333333333333,0,6,3,0,3,0,0,0,3,0.0,0,3.0
AUS,2015,July,2,2,0,0.0,1,1,0,2,2,0,0,0,4,0.0,0,4.0
LTU,2016,March,2,2,0,0.0,1,1,1,1,2,0,0,0,5,0.0,0,5.0
PHL,2016,April,5,2,3,0.6,0,3,4,1,5,0,0,0,11,0.0,0,11.0
SAU,2017,March,4,2,2,0.5,0,0,4,0,4,0,0,0,6,0.0,0,6.0
NZL,2016,November,2,2,0,0.0,0,1,1,1,2,0,0,0,3,0.0,1,4.0
KEN,2017,April,2,2,0,0.0,0,1,2,0,2,0,0,0,3,0.0,0,3.0
THA,2016,December,2,2,0,0.0,0,4,2,0,2,0,0,0,4,1.0,0,5.0
OMN,2016,April,2,2,0,0.0,0,3,0,2,2,0,0,0,4,2.0,0,6.0
KAZ,2015,September,2,2,0,0.0,0,3,2,0,0,0,2,0,4,0.0,0,4.0
DZA,2015,December,2,2,0,0.0,1,3,1,1,2,0,0,0,4,0.0,0,4.0
MLT,2016,May,2,2,0,0.0,0,0,2,0,2,0,0,0,4,0.0,0,4.0
CYP,2016,May,2,2,0,0.0,0,0,2,0,2,0,0,0,2,0.0,0,2.0
MUS,2016,February,2,2,0,0.0,0,3,1,1,2,0,0,0,4,0.0,0,4.0
LTU,2016,February,2,2,0,0.0,0,1,2,0,2,0,0,0,3,0.0,0,3.0
PRI,2016,May,2,2,0,0.0,0,0,0,2,2,0,0,0,2,0.0,0,2.0
BLR,2016,September,2,2,0,0.0,1,3,1,1,1,1,0,0,4,0.0,0,4.0
LBN,2015,September,2,2,0,0.0,0,2,2,0,1,1,0,0,4,0.0,0,4.0
SVK,2015,November,2,2,0,0.0,0,2,2,0,0,1,1,0,3,0.0,0,3.0
MUS,2015,December,2,2,0,0.0,0,4,2,0,2,0,0,0,2,0.0,0,2.0
DZA,2017,August,2,2,0,0.0,0,1,2,0,2,0,0,0,5,2.0,0,7.0
ZAF,2017,April,2,2,0,0.0,0,3,0,2,2,0,0,0,3,0.0,0,3.0
KOR,2016,July,2,2,0,0.0,0,2,2,0,0,2,0,0,4,1.0,0,5.0
DNK,2015,November,2,2,0,0.0,0,0,2,0,0,2,0,0,2,0.0,0,2.0
CRI,2016,April,2,2,0,0.0,0,0,2,0,2,0,0,0,3,0.0,0,3.0
ISL,2017,February,3,2,1,0.3333333333333333,0,6,2,1,3,0,0,0,5,0.0,0,5.0
SAU,2016,April,6,2,4,0.6666666666666666,0,3,6,0,6,0,0,0,8,2.0,0,10.0
GRC,2017,August,3,2,1,0.3333333333333333,0,2,3,0,3,0,0,0,6,1.0,0,7.0
SVN,2017,April,3,2,1,0.3333333333333333,0,0,2,1,2,1,0,0,5,2.0,0,7.0
KOR,2017,May,13,2,11,0.8461538461538461,0,5,13,0,12,1,0,0,19,0.0,0,19.0
MYS,2016,February,2,2,0,0.0,0,1,2,0,2,0,0,0,4,0.0,0,4.0
HKG,2017,April,5,2,3,0.6,0,11,5,0,5,0,0,0,10,0.0,0,10.0
LTU,2016,June,2,2,0,0.0,1,2,0,2,2,0,0,0,4,0.0,0,4.0
ARG,2015,August,2,2,0,0.0,0,1,0,2,2,0,0,0,4,0.0,0,4.0
CMR,2015,October,2,2,0,0.0,0,2,2,0,2,0,0,0,5,0.0,0,5.0
MEX,2017,June,3,2,1,0.3333333333333333,0,2,3,0,3,0,0,0,6,0.0,0,6.0
DOM,2015,October,2,2,0,0.0,0,1,1,1,2,0,0,0,4,0.0,0,4.0
UKR,2016,August,3,2,1,0.3333333333333333,0,2,3,0,3,0,0,0,8,0.0,0,8.0
EGY,2016,August,2,2,0,0.0,0,0,1,1,2,0,0,0,3,0.0,0,3.0
CPV,2017,May,2,2,0,0.0,0,2,0,2,2,0,0,0,4,0.0,0,4.0
MCO,2017,February,2,2,0,0.0,0,1,2,0,2,0,0,0,4,0.0,0,4.0
KAZ,2016,July,2,2,0,0.0,0,1,2,0,2,0,0,0,5,0.0,0,5.0
KOR,2015,December,2,2,0,0.0,0,2,1,1,2,0,0,0,3,0.0,0,3.0
MEX,2016,June,2,2,0,0.0,0,3,2,0,2,0,0,0,3,0.0,0,3.0
SVN,2015,September,2,2,0,0.0,0,2,2,0,2,0,0,0,2,0.0,0,2.0
MEX,2016,January,2,2,0,0.0,0,1,2,0,2,0,0,0,4,0.0,0,4.0
SRB,2016,May,2,2,0,0.0,0,1,2,0,1,1,0,0,2,0.0,0,2.0
HRV,2015,September,2,2,0,0.0,0,0,2,0,0,2,0,0,2,0.0,0,2.0
NZL,2016,October,2,2,0,0.0,0,3,2,0,2,0,0,0,4,0.0,0,4.0
SAU,2017,June,4,2,2,0.5,0,5,4,0,4,0,0,0,8,0.0,0,8.0
IDN,2017,May,3,2,1,0.3333333333333333,0,5,3,0,3,0,0,0,5,0.0,0,5.0
SVK,2017,July,2,2,0,0.0,0,1,2,0,2,0,0,0,5,0.0,0,5.0
JAM,2017,April,2,2,0,0.0,1,2,0,2,2,0,0,0,4,1.0,0,5.0
LTU,2016,December,2,2,0,0.0,0,2,2,0,2,0,0,0,6,0.0,0,6.0
ISR,2016,December,5,2,3,0.6,0,5,5,0,5,0,0,0,9,0.0,0,9.0
CMR,2016,October,2,2,0,0.0,0,1,1,1,2,0,0,0,4,0.0,0,4.0
COL,2016,July,2,2,0,0.0,1,3,1,1,2,0,0,0,5,0.0,0,5.0
BGD,2016,April,6,2,4,0.6666666666666666,0,1,6,0,6,0,0,0,15,0.0,0,15.0
LBN,2017,May,2,2,0,0.0,0,0,1,1,1,1,0,0,3,0.0,0,3.0
SVN,2016,July,2,2,0,0.0,0,0,1,1,2,0,0,0,4,0.0,0,4.0
HRV,2015,October,2,2,0,0.0,0,1,2,0,1,0,1,0,4,0.0,0,4.0
ARG,2015,July,2,2,0,0.0,2,1,0,2,2,0,0,0,5,0.0,0,5.0
MWI,2016,November,2,2,0,0.0,2,2,0,2,2,0,0,0,4,0.0,0,4.0
SVN,2016,May,2,2,0,0.0,0,0,2,0,1,1,0,0,2,0.0,0,2.0
LTU,2016,January,2,2,0,0.0,1,1,0,2,2,0,0,0,3,0.0,0,3.0
MAR,2015,September,2,2,0,0.0,0,2,2,0,2,0,0,0,3,0.0,1,4.0
TUN,2015,August,2,2,0,0.0,0,1,2,0,2,0,0,0,4,0.0,0,4.0
UKR,2016,July,4,2,2,0.5,0,2,4,0,4,0,0,0,5,1.0,0,6.0
CHL,2017,May,2,2,0,0.0,0,0,2,0,0,2,0,0,2,0.0,0,2.0
MLT,2017,May,3,2,1,0.3333333333333333,0,2,3,0,3,0,0,0,5,0.0,0,5.0
TWN,2017,May,2,2,0,0.0,0,1,2,0,1,1,0,0,3,0.0,0,3.0
AZE,2017,March,5,2,3,0.6,0,2,5,0,5,0,0,0,12,0.0,0,12.0
SVN,2016,December,2,2,0,0.0,0,2,2,0,2,0,0,0,3,0.0,0,3.0
NZL,2017,July,2,2,0,0.0,0,3,2,0,1,1,0,0,4,0.0,0,4.0
SRB,2015,September,2,2,0,0.0,0,1,1,1,1,1,0,0,4,1.0,0,5.0
COL,2016,May,2,2,0,0.0,0,1,2,0,1,1,0,0,3,0.0,0,3.0
EST,2015,September,2,2,0,0.0,1,3,0,2,2,0,0,0,4,0.0,0,4.0
PAK,2017,June,4,2,2,0.5,0,2,2,2,2,2,0,0,7,4.0,0,11.0
SRB,2016,January,2,2,0,0.0,0,0,2,0,0,2,0,0,2,0.0,0,2.0
COL,2015,October,2,2,0,0.0,0,4,1,1,1,0,1,0,4,0.0,0,4.0
ISR,2017,January,2,2,0,0.0,0,3,1,1,1,1,0,0,3,0.0,0,3.0
LTU,2016,May,2,2,0,0.0,1,0,1,1,2,0,0,0,4,2.0,0,6.0
MYS,2016,May,2,2,0,0.0,0,1,1,1,2,0,0,0,4,0.0,0,4.0
DOM,2016,March,1,1,0,0.0,0,1,0,1,1,0,0,0,2,0.0,0,2.0
ARG,2015,December,1,1,0,0.0,0,0,1,0,1,0,0,0,2,0.0,0,2.0
VEN,2017,July,1,1,0,0.0,0,1,1,0,1,0,0,0,2,0.0,0,2.0
AZE,2016,April,2,1,1,0.5,0,0,2,0,2,0,0,0,5,0.0,0,5.0
THA,2016,January,1,1,0,0.0,0,1,0,1,1,0,0,0,2,0.0,0,2.0
GRC,2017,January,3,1,2,0.6666666666666666,0,0,3,0,3,0,0,0,5,0.0,0,5.0
TWN,2016,May,1,1,0,0.0,0,1,1,0,1,0,0,0,2,0.0,0,2.0
ABW,2016,June,1,1,0,0.0,0,2,1,0,1,0,0,0,3,0.0,0,3.0
EGY,2016,July,1,1,0,0.0,0,1,1,0,1,0,0,0,2,0.0,0,2.0
SRB,2017,February,1,1,0,0.0,0,1,1,0,1,0,0,0,2,0.0,0,2.0
AIA,2016,July,1,1,0,0.0,0,0,1,0,1,0,0,0,2,2.0,0,4.0
ATA,2016,October,1,1,0,0.0,0,0,1,0,1,0,0,0,1,0.0,0,1.0
CRI,2017,June,1,1,0,0.0,0,1,1,0,1,0,0,0,1,0.0,0,1.0
PRI,2016,September,1,1,0,0.0,0,0,0,1,1,0,0,0,1,0.0,0,1.0
COL,2015,November,1,1,0,0.0,0,0,1,0,0,1,0,0,1,0.0,0,1.0
LBN,2016,September,1,1,0,0.0,0,1,1,0,1,0,0,0,2,0.0,0,2.0
BFA,2016,January,1,1,0,0.0,0,1,1,0,1,0,0,0,2,0.0,0,2.0
DOM,2017,April,1,1,0,0.0,0,0,1,0,0,1,0,0,2,0.0,0,2.0
CMR,2015,September,1,1,0,0.0,0,0,1,0,0,1,0,0,2,0.0,0,2.0
ATA,2017,January,1,1,0,0.0,0,1,1,0,1,0,0,0,1,0.0,0,1.0
ZAF,2016,March,2,1,1,0.5,0,0,2,0,2,0,0,0,3,0.0,0,3.0
LTU,2017,March,1,1,0,0.0,0,0,1,0,1,0,0,0,2,0.0,0,2.0
PER,2016,June,1,1,0,0.0,0,1,1,0,1,0,0,0,1,0.0,0,1.0
UKR,2017,March,1,1,0,0.0,0,1,1,0,1,0,0,0,2,0.0,0,2.0
JAM,2016,February,1,1,0,0.0,0,0,0,1,1,0,0,0,1,0.0,0,1.0
CHL,2016,August,1,1,0,0.0,0,1,1,0,1,0,0,0,2,0.0,0,2.0
OMN,2016,May,1,1,0,0.0,0,0,0,1,0,0,1,0,2,0.0,0,2.0
LTU,2017,August,1,1,0,0.0,0,1,0,1,1,0,0,0,2,1.0,0,3.0
SDN,2017,June,1,1,0,0.0,0,1,1,0,1,0,0,0,2,0.0,0,2.0
EGY,2016,November,5,1,4,0.8,0,5,5,0,5,0,0,0,7,0.0,0,7.0
SLE,2017,July,1,1,0,0.0,0,1,1,0,1,0,0,0,2,0.0,0,2.0
KEN,2016,January,1,1,0,0.0,0,1,1,0,0,1,0,0,1,2.0,0,3.0
JOR,2016,April,1,1,0,0.0,0,1,1,0,1,0,0,0,1,0.0,0,1.0
MEX,2016,February,1,1,0,0.0,0,1,0,1,1,0,0,0,2,1.0,0,3.0
ARE,2016,January,1,1,0,0.0,0,0,1,0,1,0,0,0,1,0.0,0,1.0
SUR,2017,April,1,1,0,0.0,0,4,1,0,1,0,0,0,2,0.0,0,2.0
SVK,2017,April,1,1,0,0.0,0,1,1,0,1,0,0,0,2,0.0,0,2.0
HRV,2016,October,2,1,1,0.5,0,3,2,0,2,0,0,0,4,2.0,0,6.0
MEX,2017,April,1,1,0,0.0,0,0,1,0,1,0,0,0,2,0.0,0,2.0
ECU,2016,January,2,1,1,0.5,0,3,2,0,2,0,0,0,3,0.0,0,3.0
UKR,2017,January,2,1,1,0.5,0,1,2,0,1,1,0,0,3,0.0,0,3.0
JOR,2016,October,1,1,0,0.0,0,0,1,0,1,0,0,0,1,0.0,0,1.0
ALB,2015,July,1,1,0,0.0,0,0,0,1,1,0,0,0,2,0.0,0,2.0
PRI,2015,September,1,1,0,0.0,0,2,0,1,1,0,0,0,2,0.0,1,3.0
BGR,2016,May,5,1,4,0.8,0,4,5,0,5,0,0,0,10,1.0,0,11.0
BIH,2017,March,1,1,0,0.0,0,2,1,0,1,0,0,0,2,0.0,0,2.0
SGP,2017,March,1,1,0,0.0,0,2,1,0,1,0,0,0,2,0.0,0,2.0
MLT,2017,April,1,1,0,0.0,0,0,1,0,1,0,0,0,2,0.0,0,2.0
CYM,2015,October,1,1,0,0.0,0,2,0,1,0,1,0,0,2,0.0,0,2.0
IND,2015,December,1,1,0,0.0,0,0,0,1,1,0,0,0,2,0.0,0,2.0
SAU,2016,June,4,1,3,0.75,1,0,3,1,4,0,0,0,10,3.0,0,13.0
VNM,2016,July,1,1,0,0.0,0,1,0,1,1,0,0,0,2,0.0,0,2.0
ECU,2016,February,1,1,0,0.0,0,0,1,0,1,0,0,0,2,0.0,0,2.0
IDN,2017,January,3,1,2,0.6666666666666666,0,0,2,1,2,1,0,0,4,0.0,0,4.0
DZA,2015,September,1,1,0,0.0,0,2,1,0,0,0,1,0,2,0.0,0,2.0
IND,2016,August,1,1,0,0.0,0,0,1,0,1,0,0,0,3,1.0,0,4.0
BIH,2017,April,1,1,0,0.0,0,1,1,0,1,0,0,0,3,0.0,0,3.0
KEN,2017,June,1,1,0,0.0,0,2,1,0,1,0,0,0,2,1.0,0,3.0
ALB,2016,March,1,1,0,0.0,0,2,0,1,1,0,0,0,2,0.0,1,3.0
LVA,2015,August,1,1,0,0.0,0,3,1,0,0,0,1,0,2,1.0,0,3.0
LKA,2015,December,1,1,0,0.0,0,0,0,1,1,0,0,0,2,0.0,0,2.0
BDI,2016,May,1,1,0,0.0,0,0,0,1,0,1,0,0,2,0.0,0,2.0
GAB,2016,September,2,1,1,0.5,0,1,2,0,2,0,0,0,2,0.0,0,2.0
TUN,2016,April,4,1,3,0.75,0,1,3,1,4,0,0,0,8,2.0,0,10.0
SGP,2015,October,1,1,0,0.0,0,2,1,0,1,0,0,0,2,0.0,0,2.0
CHL,2016,December,4,1,3,0.75,0,3,4,0,4,0,0,0,10,2.0,0,12.0
CRI,2015,October,1,1,0,0.0,0,1,1,0,1,0,0,0,2,0.0,0,2.0
NZL,2015,October,1,1,0,0.0,0,1,0,1,1,0,0,0,3,0.0,0,3.0
DZA,2016,June,1,1,0,0.0,0,1,1,0,1,0,0,0,1,0.0,0,1.0
MEX,2016,August,1,1,0,0.0,0,2,1,0,1,0,0,0,3,0.0,0,3.0
NZL,2016,February,1,1,0,0.0,0,0,0,1,1,0,0,0,1,0.0,0,1.0
ARM,2016,May,3,1,2,0.6666666666666666,0,0,2,1,3,0,0,0,5,0.0,0,5.0
IDN,2015,November,1,1,0,0.0,0,1,1,0,0,1,0,0,2,0.0,0,2.0
SVN,2016,January,1,1,0,0.0,0,0,1,0,0,1,0,0,1,0.0,0,1.0
CIV,2016,November,1,1,0,0.0,0,1,1,0,1,0,0,0,2,0.0,0,2.0
COL,2017,March,1,1,0,0.0,0,2,0,1,0,1,0,0,2,0.0,0,2.0
HRV,2016,March,5,1,4,0.8,0,2,5,0,4,1,0,0,11,2.0,0,13.0
AZE,2017,July,1,1,0,0.0,0,2,0,1,1,0,0,0,3,0.0,0,3.0
RWA,2016,October,1,1,0,0.0,0,0,1,0,1,0,0,0,2,0.0,0,2.0
ALB,2015,December,1,1,0,0.0,0,0,1,0,1,0,0,0,2,0.0,0,2.0
KAZ,2016,December,1,1,0,0.0,0,0,1,0,1,0,0,0,1,0.0,0,1.0
NGA,2016,September,1,1,0,0.0,0,2,0,1,1,0,0,0,2,0.0,0,2.0
LCA,2016,October,1,1,0,0.0,0,0,1,0,0,1,0,0,2,0.0,0,2.0
EST,2016,June,1,1,0,0.0,1,2,0,1,1,0,0,0,2,0.0,0,2.0
EST,2016,March,2,1,1,0.5,0,2,2,0,2,0,0,0,4,0.0,0,4.0
ARG,2015,November,1,1,0,0.0,0,0,1,0,0,1,0,0,1,0.0,0,1.0
IRN,2016,April,1,1,0,0.0,0,0,1,0,1,0,0,0,1,0.0,0,1.0
PHL,2016,October,1,1,0,0.0,0,0,1,0,1,0,0,0,2,0.0,0,2.0
BGD,2017,April,1,1,0,0.0,0,0,1,0,1,0,0,0,1,0.0,0,1.0
PRY,2017,April,1,1,0,0.0,0,0,1,0,1,0,0,0,2,0.0,0,2.0
ZAF,2015,October,1,1,0,0.0,1,0,0,1,1,0,0,0,2,2.0,0,4.0
DOM,2017,May,1,1,0,0.0,0,2,0,1,1,0,0,0,2,0.0,0,2.0
SRB,2016,November,1,1,0,0.0,0,2,1,0,1,0,0,0,2,0.0,0,2.0
ZAF,2016,February,4,1,3,0.75,1,4,4,0,4,0,0,0,6,0.0,0,6.0
MOZ,2015,September,1,1,0,0.0,0,0,1,0,1,0,0,0,2,0.0,0,2.0
MOZ,2017,January,1,1,0,0.0,0,0,1,0,1,0,0,0,1,0.0,0,1.0
URY,2016,August,2,1,1,0.5,0,1,0,2,2,0,0,0,4,0.0,0,4.0
PRI,2016,August,1,1,0,0.0,0,0,0,1,1,0,0,0,2,0.0,0,2.0
SVN,2015,November,1,1,0,0.0,0,0,1,0,0,1,0,0,1,0.0,0,1.0
UZB,2017,June,1,1,0,0.0,0,0,1,0,1,0,0,0,1,0.0,0,1.0
MYS,2016,April,1,1,0,0.0,0,0,1,0,1,0,0,0,2,0.0,0,2.0
IDN,2015,July,1,1,0,0.0,1,0,0,1,1,0,0,0,2,2.0,0,4.0
VEN,2015,August,1,1,0,0.0,0,0,1,0,0,0,1,0,2,2.0,0,4.0
PYF,2016,September,1,1,0,0.0,0,0,1,0,0,1,0,0,2,0.0,0,2.0
HRV,2016,September,2,1,1,0.5,0,4,1,1,2,0,0,0,4,0.0,0,4.0
VNM,2016,September,1,1,0,0.0,0,1,1,0,1,0,0,0,2,0.0,0,2.0
TUN,2017,February,1,1,0,0.0,0,1,1,0,1,0,0,0,2,2.0,0,4.0
OMN,2016,December,1,1,0,0.0,0,4,0,1,0,1,0,0,2,0.0,0,2.0
NAM,2016,April,1,1,0,0.0,0,0,1,0,1,0,0,0,2,0.0,0,2.0
KWT,2016,November,1,1,0,0.0,0,1,1,0,1,0,0,0,2,0.0,0,2.0
GRC,2016,May,2,1,1,0.5,0,0,2,0,2,0,0,0,3,0.0,0,3.0
SRB,2015,December,1,1,0,0.0,0,0,1,0,1,0,0,0,2,0.0,0,2.0
LKA,2016,February,1,1,0,0.0,0,2,1,0,1,0,0,0,2,0.0,0,2.0
MKD,2015,October,1,1,0,0.0,0,1,0,1,1,0,0,0,2,2.0,1,5.0
IRQ,2017,February,1,1,0,0.0,0,0,1,0,1,0,0,0,2,0.0,0,2.0
MLI,2016,April,1,1,0,0.0,0,1,1,0,1,0,0,0,2,0.0,0,2.0
MCO,2016,February,1,1,0,0.0,0,1,1,0,1,0,0,0,2,0.0,0,2.0
LKA,2017,April,1,1,0,0.0,0,0,1,0,1,0,0,0,1,0.0,0,1.0
BHS,2017,April,1,1,0,0.0,0,0,0,1,0,0,1,0,2,0.0,0,2.0
GEO,2015,November,1,1,0,0.0,0,0,1,0,0,1,0,0,1,0.0,0,1.0
SRB,2016,August,1,1,0,0.0,0,1,1,0,1,0,0,0,2,0.0,0,2.0
OMN,2015,September,1,1,0,0.0,0,3,0,1,0,0,1,0,2,0.0,0,2.0
BLR,2015,December,1,1,0,0.0,0,1,1,0,1,0,0,0,2,0.0,0,2.0
LTU,2017,June,2,1,1,0.5,0,3,1,1,2,0,0,0,4,1.0,0,5.0
ZAF,2016,July,4,1,3,0.75,0,2,4,0,4,0,0,0,7,0.0,0,7.0
OMN,2017,April,1,1,0,0.0,0,2,1,0,1,0,0,0,3,0.0,0,3.0
VNM,2017,August,1,1,0,0.0,0,1,1,0,1,0,0,0,3,0.0,0,3.0
BIH,2016,February,1,1,0,0.0,0,0,0,1,1,0,0,0,2,0.0,0,2.0
QAT,2016,August,2,1,1,0.5,0,0,1,1,2,0,0,0,4,1.0,0,5.0
BIH,2016,June,1,1,0,0.0,0,0,1,0,0,1,0,0,2,0.0,0,2.0
SUR,2016,September,1,1,0,0.0,0,1,0,1,1,0,0,0,2,0.0,0,2.0
CPV,2017,March,1,1,0,0.0,0,0,1,0,1,0,0,0,1,0.0,0,1.0
BGR,2017,July,1,1,0,0.0,0,2,1,0,1,0,0,0,2,0.0,0,2.0
PRI,2016,July,1,1,0,0.0,0,0,0,1,1,0,0,0,2,0.0,0,2.0
LVA,2016,October,1,1,0,0.0,0,1,0,1,0,0,0,1,2,0.0,0,2.0
CHL,2016,October,2,1,1,0.5,0,2,1,1,1,1,0,0,5,0.0,0,5.0
LVA,2017,July,2,1,1,0.5,0,1,1,1,2,0,0,0,5,0.0,0,5.0
NGA,2015,December,1,1,0,0.0,0,1,0,1,1,0,0,0,3,0.0,0,3.0
OMN,2017,August,1,1,0,0.0,0,0,0,1,0,1,0,0,2,0.0,0,2.0
LKA,2015,November,1,1,0,0.0,0,1,1,0,0,1,0,0,2,0.0,0,2.0
COL,2017,January,2,1,1,0.5,0,5,2,0,2,0,0,0,6,0.0,0,6.0
UGA,2016,September,1,1,0,0.0,0,0,1,0,1,0,0,0,2,0.0,0,2.0
SGP,2016,October,1,1,0,0.0,0,0,1,0,0,1,0,0,1,0.0,0,1.0
IRQ,2017,May,1,1,0,0.0,0,0,1,0,1,0,0,0,2,0.0,0,2.0
SVK,2016,October,3,1,2,0.6666666666666666,0,2,3,0,3,0,0,0,5,0.0,0,5.0
ECU,2015,December,1,1,0,0.0,1,1,1,0,0,0,1,0,2,0.0,0,2.0
HRV,2016,January,1,1,0,0.0,0,1,1,0,1,0,0,0,2,0.0,0,2.0
ISR,2016,February,1,1,0,0.0,0,0,1,0,1,0,0,0,2,0.0,0,2.0
URY,2016,July,1,1,0,0.0,1,2,1,0,1,0,0,0,2,2.0,0,4.0
CHL,2017,April,1,1,0,0.0,0,3,1,0,1,0,0,0,2,0.0,0,2.0
CHL,2016,April,6,1,5,0.8333333333333334,0,4,6,0,6,0,0,0,12,2.0,0,14.0
CZE,2016,December,2,1,1,0.5,0,2,2,0,2,0,0,0,4,0.0,0,4.0
ZMB,2015,October,1,1,0,0.0,0,3,0,1,1,0,0,0,2,2.0,0,4.0
BGR,2016,February,1,1,0,0.0,0,1,1,0,1,0,0,0,2,0.0,0,2.0
IRN,2015,October,1,1,0,0.0,0,3,1,0,0,0,1,0,2,0.0,0,2.0
SVN,2017,February,1,1,0,0.0,0,0,0,1,1,0,0,0,2,0.0,0,2.0
JPN,2016,April,2,1,1,0.5,0,1,2,0,2,0,0,0,4,0.0,0,4.0
LIE,2016,September,1,1,0,0.0,0,2,1,0,1,0,0,0,2,0.0,0,2.0
LBN,2017,July,1,1,0,0.0,0,0,1,0,1,0,0,0,1,0.0,0,1.0
TZA,2016,April,1,1,0,0.0,0,2,1,0,1,0,0,0,2,1.0,0,3.0
MEX,2016,October,2,1,1,0.5,0,2,2,0,2,0,0,0,3,0.0,0,3.0
IRQ,2015,December,1,1,0,0.0,0,0,1,0,1,0,0,0,2,0.0,0,2.0
DOM,2016,October,1,1,0,0.0,0,1,1,0,0,1,0,0,2,0.0,0,2.0
NGA,2017,April,1,1,0,0.0,0,0,0,1,1,0,0,0,2,0.0,1,3.0
MDV,2017,January,1,1,0,0.0,0,0,1,0,0,1,0,0,1,0.0,0,1.0
LTU,2017,May,1,1,0,0.0,0,2,1,0,1,0,0,0,2,0.0,0,2.0
MDV,2017,June,2,1,1,0.5,0,1,1,1,2,0,0,0,4,1.0,0,5.0
SLV,2017,August,1,1,0,0.0,0,1,1,0,1,0,0,0,2,0.0,0,2.0
MDG,2017,January,1,1,0,0.0,0,0,0,1,1,0,0,0,2,0.0,0,2.0
PAK,2017,August,1,1,0,0.0,1,0,0,1,0,1,0,0,2,0.0,0,2.0
VEN,2016,August,1,1,0,0.0,0,2,1,0,1,0,0,0,2,0.0,0,2.0
BLR,2017,July,1,1,0,0.0,0,2,1,0,1,0,0,0,2,0.0,0,2.0
MYS,2016,January,1,1,0,0.0,0,1,0,1,1,0,0,0,2,0.0,0,2.0
TUR,2016,July,7,1,6,0.8571428571428571,0,4,7,0,7,0,0,0,15,3.0,0,18.0
PER,2017,February,1,1,0,0.0,0,1,1,0,1,0,0,0,1,0.0,0,1.0
SGP,2017,June,1,1,0,0.0,0,0,1,0,1,0,0,0,3,0.0,0,3.0
THA,2015,November,1,1,0,0.0,0,0,1,0,0,1,0,0,1,0.0,0,1.0
QAT,2016,June,2,1,1,0.5,0,1,2,0,1,1,0,0,3,0.0,0,3.0
ABW,2017,May,1,1,0,0.0,0,1,1,0,1,0,0,0,2,0.0,0,2.0
FRO,2017,August,1,1,0,0.0,0,1,1,0,1,0,0,0,3,0.0,0,3.0
NZL,2017,March,1,1,0,0.0,1,0,0,1,1,0,0,0,2,0.0,0,2.0
URY,2016,September,2,1,1,0.5,0,2,1,1,2,0,0,0,4,0.0,0,4.0
ZWE,2017,February,1,1,0,0.0,0,1,0,1,1,0,0,0,2,0.0,0,2.0
GTM,2017,May,1,1,0,0.0,0,1,1,0,1,0,0,0,2,1.0,0,3.0
DJI,2017,July,1,1,0,0.0,0,0,0,1,1,0,0,0,2,2.0,0,4.0
LBN,2017,April,3,1,2,0.6666666666666666,0,1,3,0,3,0,0,0,7,0.0,0,7.0
GUY,2016,October,1,1,0,0.0,0,0,1,0,0,1,0,0,1,0.0,0,1.0
OMN,2016,January,4,1,3,0.75,1,1,4,0,1,3,0,0,6,4.0,0,10.0
KWT,2017,April,1,1,0,0.0,1,3,1,0,1,0,0,0,2,0.0,0,2.0
COL,2017,April,2,1,1,0.5,0,2,1,1,2,0,0,0,4,0.0,0,4.0
UKR,2016,February,3,1,2,0.6666666666666666,0,1,3,0,3,0,0,0,5,0.0,0,5.0
ZAF,2017,January,2,1,1,0.5,0,4,2,0,2,0,0,0,4,0.0,0,4.0
CZE,2015,December,1,1,0,0.0,0,1,0,1,1,0,0,0,2,0.0,0,2.0
PRY,2017,June,1,1,0,0.0,0,0,1,0,1,0,0,0,2,0.0,0,2.0
TJK,2017,July,1,1,0,0.0,0,1,1,0,1,0,0,0,2,0.0,0,2.0
BIH,2017,May,1,1,0,0.0,0,0,1,0,1,0,0,0,1,0.0,0,1.0
KNA,2015,November,1,1,0,0.0,0,0,1,0,0,1,0,0,1,0.0,0,1.0
IRQ,2016,September,1,1,0,0.0,0,0,1,0,0,1,0,0,1,0.0,0,1.0
AND,2016,July,2,1,1,0.5,1,0,0,2,2,0,0,0,5,1.0,0,6.0
NGA,2016,October,3,1,2,0.6666666666666666,0,3,3,0,3,0,0,0,6,0.0,0,6.0
UKR,2017,May,2,1,1,0.5,0,0,2,0,2,0,0,0,4,0.0,0,4.0
THA,2015,December,1,1,0,0.0,0,0,1,0,1,0,0,0,2,0.0,0,2.0
TWN,2016,January,1,1,0,0.0,0,2,1,0,1,0,0,0,2,0.0,0,2.0
KAZ,2015,August,1,1,0,0.0,0,1,0,1,1,0,0,0,2,0.0,0,2.0
SVK,2016,July,1,1,0,0.0,0,1,1,0,1,0,0,0,2,0.0,0,2.0
IRN,2016,May,1,1,0,0.0,0,2,1,0,1,0,0,0,2,0.0,0,2.0
CUB,2016,August,1,1,0,0.0,0,0,1,0,1,0,0,0,2,0.0,0,2.0
CUB,2017,February,1,1,0,0.0,0,0,1,0,1,0,0,0,1,0.0,0,1.0
UKR,2017,February,1,1,0,0.0,0,0,0,1,1,0,0,0,2,0.0,0,2.0
URY,2017,March,3,1,2,0.6666666666666666,0,2,2,1,2,1,0,0,8,0.0,0,8.0
KAZ,2017,April,1,1,0,0.0,0,0,0,1,1,0,0,0,1,0.0,0,1.0
NGA,2016,February,5,1,4,0.8,0,0,4,1,5,0,0,0,6,1.0,1,8.0
CUB,2016,March,1,1,0,0.0,0,0,0,1,0,1,0,0,1,0.0,0,1.0
GRC,2015,August,1,1,0,0.0,0,0,1,0,0,1,0,0,1,0.0,0,1.0
KAZ,2016,May,2,1,1,0.5,0,1,2,0,2,0,0,0,2,0.0,0,2.0
CUB,2017,March,1,1,0,0.0,0,0,1,0,1,0,0,0,1,0.0,0,1.0
ZAF,2016,May,1,1,0,0.0,0,0,1,0,0,1,0,0,1,0.0,0,1.0
VEN,2016,May,1,1,0,0.0,0,1,1,0,0,1,0,0,2,0.0,0,2.0
HRV,2016,April,3,1,2,0.6666666666666666,0,1,2,1,3,0,0,0,6,2.0,0,8.0
SVK,2017,August,1,1,0,0.0,1,2,0,1,1,0,0,0,2,0.0,0,2.0
ISL,2017,May,1,1,0,0.0,0,0,1,0,1,0,0,0,2,0.0,0,2.0
CHL,2015,September,1,1,0,0.0,0,0,0,1,1,0,0,0,2,0.0,0,2.0
AZE,2016,July,2,1,1,0.5,0,1,1,1,2,0,0,0,2,1.0,0,3.0
PRY,2016,June,1,1,0,0.0,0,2,1,0,1,0,0,0,2,0.0,0,2.0
ISL,2017,June,1,1,0,0.0,0,0,1,0,1,0,0,0,2,0.0,0,2.0
SUR,2016,February,1,1,0,0.0,0,0,0,1,1,0,0,0,2,2.0,0,4.0
HRV,2015,August,1,1,0,0.0,0,2,1,0,0,0,1,0,2,0.0,0,2.0
SRB,2017,March,1,1,0,0.0,0,1,1,0,1,0,0,0,2,0.0,0,2.0
JAM,2016,May,1,1,0,0.0,0,3,0,1,0,1,0,0,2,1.0,0,3.0
NGA,2015,November,1,1,0,0.0,0,0,0,1,1,0,0,0,2,0.0,0,2.0
SVK,2016,April,3,1,2,0.6666666666666666,0,0,3,0,3,0,0,0,6,0.0,0,6.0
SAU,2016,July,2,1,1,0.5,0,0,2,0,2,0,0,0,4,0.0,0,4.0
OMN,2015,October,1,1,0,0.0,0,1,0,1,1,0,0,0,1,0.0,0,1.0
BLR,2017,June,1,1,0,0.0,0,0,1,0,1,0,0,0,2,0.0,0,2.0
HKG,2017,July,4,1,3,0.75,0,4,2,2,4,0,0,0,8,0.0,0,8.0
PAN,2016,February,1,1,0,0.0,0,0,1,0,0,1,0,0,2,0.0,0,2.0
SRB,2016,December,1,1,0,0.0,0,2,1,0,1,0,0,0,2,0.0,0,2.0
LBN,2016,February,1,1,0,0.0,0,1,1,0,1,0,0,0,1,0.0,0,1.0
DZA,2016,July,3,1,2,0.6666666666666666,0,3,1,2,3,0,0,0,6,2.0,0,8.0
EST,2017,May,2,1,1,0.5,0,0,1,1,2,0,0,0,3,0.0,0,3.0
ISL,2016,September,2,1,1,0.5,0,1,2,0,2,0,0,0,4,2.0,0,6.0
SLV,2016,July,1,1,0,0.0,0,2,1,0,1,0,0,0,3,0.0,0,3.0
TWN,2017,June,1,1,0,0.0,0,0,1,0,1,0,0,0,2,0.0,0,2.0
CAF,2017,August,1,1,0,0.0,0,1,1,0,0,1,0,0,2,0.0,0,2.0
ZAF,2017,March,4,1,3,0.75,0,1,3,1,4,0,0,0,6,0.0,0,6.0
IDN,2015,September,1,1,0,0.0,0,0,1,0,1,0,0,0,1,0.0,0,1.0
IND,2015,August,1,1,0,0.0,0,4,0,1,1,0,0,0,2,1.0,0,3.0
EST,2016,July,1,1,0,0.0,0,1,0,1,1,0,0,0,2,0.0,0,2.0
ARM,2016,March,1,1,0,0.0,0,0,1,0,1,0,0,0,2,0.0,0,2.0
MYS,2017,August,1,1,0,0.0,0,2,1,0,1,0,0,0,3,0.0,0,3.0
NGA,2017,July,1,1,0,0.0,0,0,0,1,1,0,0,0,2,2.0,0,4.0
ARE,2016,October,1,1,0,0.0,0,0,1,0,1,0,0,0,2,0.0,0,2.0
UGA,2016,March,1,1,0,0.0,0,1,0,1,1,0,0,0,1,0.0,0,1.0
JOR,2016,January,1,1,0,0.0,0,0,1,0,0,1,0,0,1,0.0,0,1.0
CPV,2015,September,1,1,0,0.0,0,0,1,0,1,0,0,0,1,0.0,0,1.0
STP,2017,May,1,1,0,0.0,0,0,1,0,1,0,0,0,2,0.0,0,2.0
IND,2016,June,3,1,2,0.6666666666666666,0,3,2,1,3,0,0,0,7,2.0,0,9.0
FIN,2015,August,1,1,0,0.0,0,0,1,0,1,0,0,0,2,0.0,0,2.0
TUN,2017,July,1,1,0,0.0,0,0,1,0,1,0,0,0,2,0.0,0,2.0
CYP,2017,June,1,1,0,0.0,0,0,0,1,1,0,0,0,2,0.0,0,2.0
CHL,2016,November,1,1,0,0.0,0,2,1,0,1,0,0,0,2,0.0,0,2.0
CYP,2017,February,1,1,0,0.0,0,1,1,0,1,0,0,0,1,0.0,0,1.0
EST,2016,January,1,1,0,0.0,1,1,0,1,1,0,0,0,1,0.0,0,1.0
UKR,2016,June,1,1,0,0.0,0,2,1,0,1,0,0,0,2,0.0,0,2.0
MLT,2016,June,1,1,0,0.0,0,0,1,0,1,0,0,0,1,0.0,0,1.0
SUR,2016,October,1,1,0,0.0,1,0,0,1,0,1,0,0,2,0.0,0,2.0
ZAF,2015,November,1,1,0,0.0,0,0,1,0,0,1,0,0,1,0.0,0,1.0
NZL,2017,January,1,1,0,0.0,0,2,1,0,1,0,0,0,1,0.0,0,1.0
MUS,2017,March,1,1,0,0.0,0,1,1,0,1,0,0,0,2,0.0,0,2.0
CAF,2016,September,1,1,0,0.0,0,1,0,1,1,0,0,0,1,0.0,0,1.0
PLW,2016,July,1,1,0,0.0,0,2,0,1,1,0,0,0,2,0.0,0,2.0
TUR,2017,July,3,1,2,0.6666666666666666,0,3,3,0,3,0,0,0,4,0.0,0,4.0
STP,2015,August,1,1,0,0.0,0,3,1,0,1,0,0,0,2,0.0,0,2.0
LIE,2015,September,1,1,0,0.0,0,0,1,0,1,0,0,0,2,0.0,0,2.0
MMR,2015,October,1,1,0,0.0,0,0,1,0,1,0,0,0,2,0.0,0,2.0
PAN,2017,May,1,1,0,0.0,0,0,1,0,1,0,0,0,3,0.0,0,3.0
ZAF,2015,December,1,1,0,0.0,0,2,0,1,1,0,0,0,2,0.0,0,2.0
THA,2017,May,3,1,2,0.6666666666666666,0,2,3,0,3,0,0,0,8,0.0,0,8.0
BLR,2017,August,5,1,4,0.8,0,2,5,0,5,0,0,0,9,0.0,0,9.0
BGR,2016,September,1,1,0,0.0,0,0,1,0,1,0,0,0,3,0.0,0,3.0
THA,2016,March,1,1,0,0.0,1,0,0,1,1,0,0,0,2,0.0,0,2.0
EST,2017,August,1,1,0,0.0,0,1,0,1,1,0,0,0,2,0.0,0,2.0
SEN,2015,November,1,1,0,0.0,0,0,1,0,0,1,0,0,2,0.0,0,2.0
SAU,2016,January,4,1,3,0.75,0,0,4,0,3,1,0,0,6,0.0,0,6.0
DMA,2016,August,1,1,0,0.0,0,1,1,0,1,0,0,0,2,0.0,0,2.0
GRC,2015,December,1,1,0,0.0,0,0,1,0,1,0,0,0,1,0.0,0,1.0
SVK,2016,March,1,1,0,0.0,0,1,1,0,1,0,0,0,2,1.0,0,3.0
CAF,2017,May,1,1,0,0.0,0,1,1,0,1,0,0,0,1,0.0,0,1.0
NCL,2017,May,1,1,0,0.0,0,2,1,0,1,0,0,0,2,0.0,0,2.0
KIR,2017,June,1,1,0,0.0,0,0,1,0,1,0,0,0,1,0.0,0,1.0
EGY,2015,September,1,1,0,0.0,0,0,1,0,0,1,0,0,1,0.0,0,1.0
KAZ,2016,September,1,1,0,0.0,0,2,1,0,1,0,0,0,2,0.0,0,2.0
PRI,2015,October,1,1,0,0.0,0,0,0,1,1,0,0,0,2,0.0,0,2.0
DZA,2017,February,3,1,2,0.6666666666666666,0,1,3,0,3,0,0,0,5,0.0,0,5.0
SVN,2016,September,1,1,0,0.0,0,1,1,0,1,0,0,0,1,0.0,0,1.0
HUN,2015,July,1,1,0,0.0,1,1,0,1,1,0,0,0,2,0.0,0,2.0
ISL,2017,August,1,1,0,0.0,0,2,0,1,1,0,0,0,2,0.0,0,2.0
PHL,2016,December,2,1,1,0.5,0,3,2,0,2,0,0,0,4,2.0,0,6.0
TWN,2015,December,1,1,0,0.0,0,0,1,0,1,0,0,0,2,0.0,0,2.0
TWN,2015,November,1,1,0,0.0,0,1,1,0,0,0,1,0,1,0.0,0,1.0
CHL,2016,January,1,1,0,0.0,0,0,1,0,0,1,0,0,1,0.0,0,1.0
PHL,2015,December,1,1,0,0.0,1,0,1,0,1,0,0,0,2,0.0,0,2.0
VEN,2017,June,1,1,0,0.0,0,0,1,0,1,0,0,0,2,0.0,1,3.0
MDV,2016,October,1,1,0,0.0,0,0,0,1,1,0,0,0,2,0.0,0,2.0
CPV,2017,April,1,1,0,0.0,0,1,0,1,1,0,0,0,2,0.0,0,2.0
UKR,2015,August,1,1,0,0.0,0,0,1,0,0,0,1,0,1,0.0,0,1.0
UKR,2017,April,1,1,0,0.0,1,2,1,0,1,0,0,0,2,1.0,0,3.0
LVA,2017,May,1,1,0,0.0,0,0,0,1,0,0,1,0,2,0.0,0,2.0
TWN,2016,July,1,1,0,0.0,0,0,1,0,1,0,0,0,3,0.0,0,3.0
ISL,2016,November,1,1,0,0.0,0,0,1,0,1,0,0,0,1,0.0,0,1.0
KNA,2017,July,1,1,0,0.0,0,0,1,0,0,1,0,0,2,0.0,0,2.0
ARE,2017,July,3,1,2,0.6666666666666666,0,3,2,1,3,0,0,0,6,1.0,0,7.0
SYR,2016,March,1,1,0,0.0,0,0,0,1,0,1,0,0,2,0.0,0,2.0
QAT,2017,February,1,1,0,0.0,0,0,1,0,0,1,0,0,1,0.0,0,1.0
THA,2015,September,1,1,0,0.0,0,1,0,1,1,0,0,0,2,0.0,0,2.0
SAU,2015,November,1,1,0,0.0,0,0,1,0,0,1,0,0,1,0.0,0,1.0
ATF,2017,July,1,1,0,0.0,0,0,1,0,1,0,0,0,2,0.0,0,2.0
IRN,2017,April,2,1,1,0.5,0,1,1,1,1,1,0,0,3,0.0,0,3.0
THA,2016,February,5,1,4,0.8,0,8,5,0,5,0,0,0,10,0.0,0,10.0
KWT,2016,February,1,1,0,0.0,0,1,1,0,1,0,0,0,3,0.0,0,3.0
JOR,2016,February,1,1,0,0.0,0,1,1,0,1,0,0,0,1,0.0,0,1.0
CZE,2016,April,2,1,1,0.5,0,0,2,0,2,0,0,0,4,0.0,0,4.0
TUN,2016,May,3,1,2,0.6666666666666666,0,1,3,0,3,0,0,0,5,0.0,0,5.0
PAK,2016,May,1,1,0,0.0,0,1,1,0,1,0,0,0,2,0.0,0,2.0
HRV,2017,August,2,1,1,0.5,1,2,1,1,2,0,0,0,4,0.0,0,4.0
AZE,2016,March,3,1,2,0.6666666666666666,0,0,3,0,3,0,0,0,6,6.0,0,12.0
CYP,2016,June,1,1,0,0.0,0,0,1,0,0,1,0,0,2,0.0,0,2.0
BWA,2015,July,1,1,0,0.0,0,3,0,1,1,0,0,0,2,1.0,0,3.0
COL,2016,April,1,1,0,0.0,0,1,1,0,1,0,0,0,2,0.0,0,2.0
NPL,2017,April,1,1,0,0.0,0,1,0,1,1,0,0,0,2,0.0,0,2.0
VEN,2016,February,1,1,0,0.0,0,0,1,0,0,1,0,0,1,0.0,0,1.0
VNM,2016,August,1,1,0,0.0,0,1,1,0,1,0,0,0,2,0.0,0,2.0
LBY,2017,July,1,1,0,0.0,0,3,1,0,1,0,0,0,2,1.0,0,3.0
TGO,2017,June,1,1,0,0.0,0,2,0,1,1,0,0,0,2,0.0,0,2.0
IND,2016,February,3,1,2,0.6666666666666666,0,0,3,0,3,0,0,0,6,0.0,0,6.0
SRB,2016,April,1,1,0,0.0,0,1,1,0,1,0,0,0,2,0.0,0,2.0
JAM,2016,June,1,1,0,0.0,0,1,1,0,1,0,0,0,2,0.0,0,2.0
SYC,2016,June,1,1,0,0.0,0,0,1,0,1,0,0,0,1,0.0,0,1.0
ETH,2015,December,1,1,0,0.0,0,1,1,0,1,0,0,0,3,0.0,0,3.0
CRI,2015,September,1,1,0,0.0,0,2,1,0,1,0,0,0,2,0.0,0,2.0
EST,2015,July,1,1,0,0.0,0,0,0,1,1,0,0,0,2,2.0,0,4.0
COM,2016,February,1,1,0,0.0,0,2,0,1,1,0,0,0,2,1.0,0,3.0
SVN,2016,August,3,1,2,0.6666666666666666,1,0,2,1,3,0,0,0,7,2.0,0,9.0
MRT,2017,April,1,1,0,0.0,0,1,1,0,1,0,0,0,2,0.0,0,2.0
GAB,2016,October,1,1,0,0.0,0,0,1,0,1,0,0,0,2,1.0,0,3.0
QAT,2017,August,1,1,0,0.0,0,0,1,0,1,0,0,0,2,0.0,0,2.0
COM,2017,August,1,1,0,0.0,0,0,1,0,1,0,0,0,2,2.0,0,4.0
LVA,2017,June,2,1,1,0.5,0,3,0,2,2,0,0,0,4,0.0,0,4.0
TUN,2015,December,1,1,0,0.0,0,0,1,0,1,0,0,0,2,0.0,0,2.0
KWT,2016,October,1,1,0,0.0,0,0,1,0,1,0,0,0,2,0.0,0,2.0
SGP,2016,July,2,1,1,0.5,0,1,1,1,2,0,0,0,4,0.0,0,4.0
MYS,2017,January,1,1,0,0.0,0,1,0,1,0,1,0,0,1,0.0,0,1.0
AGO,2017,August,7,1,6,0.8571428571428571,0,10,3,4,7,0,0,0,14,2.0,0,16.0
LUX,2016,December,11,1,10,0.9090909090909091,0,9,11,0,11,0,0,0,22,1.0,0,23.0
TZA,2016,March,1,1,0,0.0,0,0,1,0,1,0,0,0,2,0.0,0,2.0
MYS,2016,September,2,1,1,0.5,0,2,2,0,2,0,0,0,4,0.0,0,4.0
CIV,2017,April,1,1,0,0.0,0,0,1,0,1,0,0,0,2,0.0,0,2.0
KWT,2016,June,1,1,0,0.0,1,1,0,1,1,0,0,0,2,0.0,0,2.0
PER,2017,March,3,1,2,0.6666666666666666,0,1,3,0,3,0,0,0,7,0.0,0,7.0
PAN,2015,November,1,1,0,0.0,0,0,1,0,1,0,0,0,2,0.0,0,2.0
ARM,2016,January,1,1,0,0.0,0,0,1,0,0,1,0,0,2,0.0,0,2.0
CRI,2017,January,1,1,0,0.0,0,3,1,0,1,0,0,0,3,0.0,0,3.0
TWN,2017,January,2,1,1,0.5,0,5,2,0,2,0,0,0,4,0.0,0,4.0
JOR,2017,February,1,1,0,0.0,0,0,1,0,1,0,0,0,1,0.0,0,1.0
BGR,2015,November,1,1,0,0.0,0,0,1,0,0,1,0,0,1,0.0,0,1.0
NZL,2016,April,2,1,1,0.5,0,6,2,0,2,0,0,0,3,0.0,0,3.0
MUS,2017,February,1,1,0,0.0,0,0,1,0,1,0,0,0,2,0.0,0,2.0
CMR,2016,May,1,1,0,0.0,0,0,1,0,1,0,0,0,2,0.0,0,2.0
TGO,2017,February,1,1,0,0.0,0,0,1,0,1,0,0,0,2,0.0,0,2.0
GRC,2015,July,1,1,0,0.0,0,1,0,1,1,0,0,0,2,0.0,0,2.0
ALB,2017,February,1,1,0,0.0,0,1,1,0,1,0,0,0,2,0.0,0,2.0
TUN,2015,November,1,1,0,0.0,0,0,1,0,0,1,0,0,1,0.0,0,1.0
SEN,2016,September,1,1,0,0.0,0,0,1,0,0,1,0,0,2,0.0,0,2.0
UKR,2016,December,6,1,5,0.8333333333333334,0,3,6,0,6,0,0,0,13,1.0,0,14.0
ARM,2016,February,1,1,0,0.0,0,0,1,0,1,0,0,0,2,0.0,0,2.0
SVN,2017,May,1,1,0,0.0,0,0,1,0,1,0,0,0,1,0.0,0,1.0
EGY,2015,December,1,1,0,0.0,0,1,1,0,1,0,0,0,2,0.0,0,2.0
PRY,2017,August,1,1,0,0.0,0,0,1,0,1,0,0,0,2,0.0,0,2.0
ETH,2017,August,1,1,0,0.0,0,0,1,0,1,0,0,0,2,0.0,0,2.0
CYP,2016,January,1,1,0,0.0,1,0,0,1,1,0,0,0,1,0.0,0,1.0
NZL,2015,August,1,1,0,0.0,0,2,0,1,1,0,0,0,3,0.0,0,3.0
DNK,2016,January,1,1,0,0.0,0,0,1,0,0,1,0,0,1,0.0,0,1.0
GHA,2017,February,1,1,0,0.0,0,0,1,0,1,0,0,0,1,0.0,0,1.0
ARM,2017,July,1,1,0,0.0,0,0,1,0,1,0,0,0,2,3.0,0,5.0
IRN,2016,July,1,1,0,0.0,0,2,0,1,1,0,0,0,2,0.0,0,2.0
BLR,2017,March,1,1,0,0.0,0,0,1,0,1,0,0,0,0,1.0,0,1.0
CUB,2016,January,1,1,0,0.0,0,2,0,1,1,0,0,0,2,0.0,0,2.0
JOR,2016,March,1,1,0,0.0,0,0,0,1,1,0,0,0,2,0.0,0,2.0
TUN,2016,January,1,1,0,0.0,0,0,1,0,1,0,0,0,2,0.0,0,2.0
VEN,2016,March,3,1,2,0.6666666666666666,0,2,3,0,3,0,0,0,8,0.0,0,8.0
KWT,2015,November,1,1,0,0.0,0,0,1,0,0,1,0,0,2,0.0,0,2.0
IRN,2017,January,3,1,2,0.6666666666666666,0,2,3,0,3,0,0,0,5,1.0,0,6.0
CMR,2017,April,1,1,0,0.0,0,0,1,0,1,0,0,0,1,0.0,0,1.0
GIB,2016,July,1,1,0,0.0,0,3,0,1,1,0,0,0,2,1.0,1,4.0
JAM,2017,February,1,1,0,0.0,0,0,0,1,0,1,0,0,3,0.0,0,3.0
SGP,2015,November,1,1,0,0.0,0,0,1,0,0,1,0,0,2,0.0,0,2.0
IRN,2016,January,1,1,0,0.0,0,0,0,1,1,0,0,0,2,0.0,0,2.0
MAC,2017,June,2,1,1,0.5,0,2,1,1,1,1,0,0,3,0.0,0,3.0
VEN,2015,September,1,1,0,0.0,0,0,1,0,1,0,0,0,1,0.0,0,1.0
TWN,2017,April,1,1,0,0.0,0,1,1,0,1,0,0,0,2,0.0,0,2.0
PRI,2017,June,1,1,0,0.0,0,1,1,0,1,0,0,0,1,0.0,0,1.0
HRV,2015,July,1,1,0,0.0,0,1,0,1,1,0,0,0,2,0.0,0,2.0
COL,2015,August,1,1,0,0.0,0,1,1,0,0,0,1,0,3,0.0,0,3.0
NZL,2017,August,1,1,0,0.0,0,0,1,0,1,0,0,0,2,0.0,0,2.0
SGP,2016,June,3,1,2,0.6666666666666666,0,1,3,0,3,0,0,0,7,0.0,0,7.0
ISL,2016,May,1,1,0,0.0,0,1,1,0,1,0,0,0,2,0.0,0,2.0
IDN,2017,June,4,1,3,0.75,0,4,2,2,4,0,0,0,8,0.0,0,8.0
NZL,2015,July,1,1,0,0.0,0,0,0,1,1,0,0,0,2,0.0,0,2.0
CZE,2016,February,1,1,0,0.0,0,0,1,0,1,0,0,0,2,0.0,0,2.0
AND,2017,July,1,1,0,0.0,1,0,0,1,1,0,0,0,2,1.0,0,3.0
SGP,2017,April,2,1,1,0.5,0,1,2,0,2,0,0,0,3,0.0,0,3.0
SEN,2017,February,1,1,0,0.0,0,1,1,0,1,0,0,0,2,0.0,0,2.0
LVA,2016,January,1,1,0,0.0,0,0,1,0,0,1,0,0,1,0.0,0,1.0
TMP,2016,June,1,1,0,0.0,1,3,1,0,1,0,0,0,2,2.0,0,4.0
SVN,2017,June,3,1,2,0.6666666666666666,0,2,2,1,3,0,0,0,6,2.0,0,8.0
VNM,2017,July,1,1,0,0.0,0,1,0,1,0,1,0,0,2,0.0,0,2.0
PHL,2017,March,1,1,0,0.0,1,1,1,0,1,0,0,0,2,0.0,0,2.0
VNM,2017,June,1,1,0,0.0,0,0,1,0,1,0,0,0,2,0.0,0,2.0
DZA,2016,January,2,1,1,0.5,0,2,2,0,2,0,0,0,3,0.0,0,3.0
CRI,2015,November,1,1,0,0.0,0,1,1,0,1,0,0,0,2,0.0,0,2.0
PAK,2017,May,1,1,0,0.0,0,1,0,1,1,0,0,0,2,0.0,0,2.0
BLR,2016,January,2,1,1,0.5,0,0,2,0,1,1,0,0,2,0.0,0,2.0
TWN,2016,June,1,1,0,0.0,0,1,1,0,1,0,0,0,2,0.0,0,2.0
CUB,2016,December,1,1,0,0.0,0,2,1,0,1,0,0,0,2,0.0,1,3.0
AGO,2017,July,5,1,4,0.8,1,6,3,2,5,0,0,0,9,0.0,0,9.0
RWA,2016,February,1,1,0,0.0,0,1,1,0,1,0,0,0,1,0.0,0,1.0
IDN,2016,March,1,1,0,0.0,0,1,1,0,1,0,0,0,1,0.0,0,1.0
JOR,2017,August,1,1,0,0.0,0,0,1,0,1,0,0,0,2,0.0,0,2.0
JOR,2017,June,1,1,0,0.0,0,1,0,1,1,0,0,0,2,0.0,0,2.0
CHL,2017,July,1,1,0,0.0,0,2,1,0,1,0,0,0,2,0.0,0,2.0
SVN,2015,July,1,1,0,0.0,1,1,0,1,1,0,0,0,2,0.0,0,2.0
OMN,2016,June,1,1,0,0.0,0,0,1,0,0,1,0,0,1,0.0,0,1.0
SYR,2017,April,1,1,0,0.0,0,3,1,0,1,0,0,0,2,0.0,0,2.0
VEN,2017,May,1,1,0,0.0,0,0,1,0,1,0,0,0,2,0.0,0,2.0
CZE,2015,July,1,1,0,0.0,0,0,0,1,1,0,0,0,2,0.0,0,2.0
BGR,2015,October,1,1,0,0.0,0,1,1,0,0,0,1,0,2,0.0,0,2.0
CYP,2016,December,1,1,0,0.0,0,0,0,1,1,0,0,0,2,0.0,0,2.0
TUN,2016,October,4,1,3,0.75,0,4,4,0,4,0,0,0,8,0.0,0,8.0
CPV,2017,February,1,1,0,0.0,0,1,1,0,1,0,0,0,2,0.0,0,2.0
MEX,2016,April,1,1,0,0.0,0,1,0,1,1,0,0,0,2,0.0,0,2.0
COL,2016,October,1,1,0,0.0,0,1,0,1,1,0,0,0,2,0.0,0,2.0
TUN,2016,September,1,1,0,0.0,0,0,1,0,1,0,0,0,2,0.0,0,2.0
ASM,2017,January,1,1,0,0.0,0,1,1,0,1,0,0,0,2,0.0,0,2.0
CPV,2015,October,1,1,0,0.0,0,0,0,1,1,0,0,0,2,0.0,0,2.0
KAZ,2016,March,1,1,0,0.0,0,2,1,0,1,0,0,0,2,0.0,0,2.0
OMN,2015,July,1,1,0,0.0,0,0,0,1,0,0,1,0,2,0.0,0,2.0
SMR,2015,September,1,1,0,0.0,0,0,0,1,0,1,0,0,2,0.0,0,2.0
OMN,2016,February,1,1,0,0.0,0,1,0,1,1,0,0,0,2,0.0,0,2.0
ZWE,2015,November,1,1,0,0.0,0,0,0,1,1,0,0,0,2,0.0,0,2.0
BIH,2016,July,1,1,0,0.0,0,0,1,0,0,1,0,0,1,0.0,0,1.0
GHA,2017,January,1,1,0,0.0,0,1,1,0,1,0,0,0,2,0.0,0,2.0
SYR,2017,February,1,1,0,0.0,0,0,1,0,0,1,0,0,1,0.0,0,1.0
TMP,2015,December,1,1,0,0.0,0,2,1,0,1,0,0,0,3,0.0,0,3.0
BHR,2016,April,1,1,0,0.0,0,2,1,0,1,0,0,0,2,0.0,0,2.0
MAR,2015,July,1,1,0,0.0,0,1,0,1,1,0,0,0,2,0.0,0,2.0
KAZ,2016,April,2,1,1,0.5,0,0,2,0,1,1,0,0,2,2.0,0,4.0
DZA,2016,February,1,1,0,0.0,0,0,1,0,0,1,0,0,1,0.0,0,1.0
ARM,2015,November,1,1,0,0.0,0,0,0,1,1,0,0,0,2,0.0,0,2.0
CMR,2016,January,1,1,0,0.0,0,2,0,1,1,0,0,0,2,0.0,0,2.0
MYS,2016,October,1,1,0,0.0,0,3,1,0,1,0,0,0,2,1.0,0,3.0
MLT,2017,June,1,1,0,0.0,0,2,1,0,1,0,0,0,2,0.0,0,2.0
SUR,2017,May,1,1,0,0.0,0,1,0,1,1,0,0,0,2,0.0,0,2.0
UZB,2017,February,1,1,0,0.0,0,1,0,1,1,0,0,0,2,0.0,0,2.0
PHL,2017,July,2,1,1,0.5,0,2,2,0,1,1,0,0,5,0.0,0,5.0
SGP,2016,April,1,0,1,1.0,0,1,1,0,1,0,0,0,1,0.0,0,1.0
TWN,2016,December,1,0,1,1.0,0,0,1,0,1,0,0,0,3,0.0,0,3.0
LUX,2017,January,4,0,4,1.0,0,1,2,2,4,0,0,0,9,1.0,0,10.0
BEN,2017,May,2,0,2,1.0,0,4,2,0,2,0,0,0,4,0.0,0,4.0
SEN,2017,July,1,0,1,1.0,0,0,0,1,1,0,0,0,2,2.0,0,4.0
THA,2017,March,1,0,1,1.0,0,1,1,0,1,0,0,0,2,0.0,0,2.0
GLP,2016,December,2,0,2,1.0,0,2,2,0,2,0,0,0,6,0.0,0,6.0
FRO,2017,July,4,0,4,1.0,0,3,4,0,4,0,0,0,12,0.0,0,12.0
UMI,2017,May,1,0,1,1.0,0,1,1,0,1,0,0,0,2,0.0,0,2.0
LBN,2017,June,2,0,2,1.0,0,2,0,2,2,0,0,0,4,0.0,0,4.0
MDV,2016,November,1,0,1,1.0,0,0,1,0,1,0,0,0,2,0.0,0,2.0
TUN,2017,April,3,0,3,1.0,0,4,3,0,3,0,0,0,6,0.0,0,6.0
KHM,2016,April,2,0,2,1.0,0,0,2,0,2,0,0,0,4,0.0,0,4.0
SAU,2016,November,5,0,5,1.0,0,0,5,0,5,0,0,0,9,0.0,0,9.0
SEN,2016,December,1,0,1,1.0,0,0,1,0,1,0,0,0,1,0.0,0,1.0
SRB,2016,February,1,0,1,1.0,0,1,1,0,1,0,0,0,2,0.0,0,2.0
HKG,2016,April,1,0,1,1.0,0,0,1,0,1,0,0,0,1,0.0,0,1.0
MYT,2017,August,1,0,1,1.0,0,0,1,0,1,0,0,0,2,2.0,0,4.0
MDV,2017,July,1,0,1,1.0,0,0,0,1,1,0,0,0,2,1.0,0,3.0
MNE,2017,June,1,0,1,1.0,0,1,1,0,1,0,0,0,2,1.0,0,3.0
MDV,2016,July,1,0,1,1.0,0,0,1,0,1,0,0,0,2,0.0,0,2.0
MLT,2016,August,2,0,2,1.0,0,2,2,0,2,0,0,0,5,1.0,0,6.0
AND,2017,April,1,0,1,1.0,0,0,1,0,1,0,0,0,2,0.0,0,2.0
SEN,2017,June,1,0,1,1.0,0,0,1,0,1,0,0,0,2,2.0,0,4.0
SAU,2017,August,2,0,2,1.0,0,2,2,0,2,0,0,0,4,2.0,0,6.0
QAT,2016,April,3,0,3,1.0,0,0,3,0,3,0,0,0,6,1.0,0,7.0
GEO,2016,March,2,0,2,1.0,0,1,2,0,2,0,0,0,4,0.0,0,4.0
GIB,2017,July,1,0,1,1.0,0,1,0,1,1,0,0,0,2,0.0,0,2.0
IMN,2016,May,1,0,1,1.0,0,0,1,0,1,0,0,0,2,0.0,0,2.0
THA,2017,July,1,0,1,1.0,0,0,1,0,1,0,0,0,2,2.0,0,4.0
ALB,2016,June,1,0,1,1.0,0,0,0,1,1,0,0,0,2,0.0,0,2.0
HKG,2016,June,6,0,6,1.0,0,1,5,1,6,0,0,0,11,0.0,0,11.0
MAC,2016,July,2,0,2,1.0,0,0,2,0,2,0,0,0,4,0.0,0,4.0
PAK,2016,July,1,0,1,1.0,0,0,1,0,1,0,0,0,2,0.0,0,2.0
ECU,2016,October,1,0,1,1.0,0,1,1,0,1,0,0,0,2,0.0,0,2.0
GIB,2016,August,3,0,3,1.0,0,4,1,2,3,0,0,0,6,0.0,0,6.0
FJI,2017,May,1,0,1,1.0,0,0,0,1,1,0,0,0,2,2.0,0,4.0
CPV,2016,February,2,0,2,1.0,0,0,2,0,2,0,0,0,3,0.0,0,3.0
VEN,2016,September,4,0,4,1.0,0,4,4,0,4,0,0,0,8,0.0,0,8.0
JEY,2016,October,1,0,1,1.0,0,0,0,1,1,0,0,0,2,0.0,0,2.0
HND,2016,February,1,0,1,1.0,0,0,1,0,1,0,0,0,2,0.0,0,2.0
ECU,2017,April,3,0,3,1.0,0,0,3,0,3,0,0,0,5,0.0,0,5.0
LIE,2017,February,1,0,1,1.0,0,1,1,0,1,0,0,0,2,0.0,0,2.0
VEN,2017,April,1,0,1,1.0,0,0,0,1,1,0,0,0,3,1.0,0,4.0
NGA,2016,May,1,0,1,1.0,0,1,1,0,1,0,0,0,1,2.0,0,3.0
JEY,2016,December,1,0,1,1.0,0,0,1,0,1,0,0,0,2,0.0,0,2.0
MDV,2017,April,2,0,2,1.0,0,1,0,2,2,0,0,0,3,2.0,0,5.0
SAU,2016,May,1,0,1,1.0,0,0,1,0,1,0,0,0,2,0.0,0,2.0
MOZ,2017,February,1,0,1,1.0,0,1,0,1,1,0,0,0,2,0.0,0,2.0
GGY,2016,December,1,0,1,1.0,0,0,0,1,0,1,0,0,1,0.0,0,1.0
ARE,2017,June,4,0,4,1.0,0,3,2,2,4,0,0,0,8,2.0,0,10.0
HKG,2016,December,1,0,1,1.0,0,2,1,0,1,0,0,0,2,0.0,0,2.0
TWN,2017,March,1,0,1,1.0,0,0,1,0,1,0,0,0,2,1.0,0,3.0
CYP,2017,April,5,0,5,1.0,0,2,5,0,5,0,0,0,8,0.0,0,8.0
BEN,2016,July,1,0,1,1.0,0,0,1,0,1,0,0,0,2,0.0,0,2.0
MDV,2016,May,1,0,1,1.0,0,0,1,0,1,0,0,0,2,0.0,0,2.0
TZA,2016,September,2,0,2,1.0,0,4,2,0,2,0,0,0,1,2.0,0,3.0
TWN,2016,February,1,0,1,1.0,0,1,1,0,1,0,0,0,2,0.0,0,2.0
CYP,2017,July,1,0,1,1.0,0,0,0,1,1,0,0,0,3,1.0,0,4.0
THA,2016,June,1,0,1,1.0,0,0,1,0,1,0,0,0,2,0.0,0,2.0
JEY,2017,June,1,0,1,1.0,0,0,1,0,1,0,0,0,2,2.0,0,4.0
MYT,2017,June,1,0,1,1.0,0,1,1,0,1,0,0,0,2,0.0,0,2.0
GHA,2016,November,1,0,1,1.0,0,0,1,0,1,0,0,0,2,0.0,0,2.0
IDN,2016,November,1,0,1,1.0,0,2,1,0,1,0,0,0,2,0.0,0,2.0
MDV,2016,December,1,0,1,1.0,0,0,1,0,1,0,0,0,2,0.0,0,2.0
BGD,2017,June,1,0,1,1.0,0,0,1,0,1,0,0,0,2,2.0,0,4.0
NGA,2017,June,1,0,1,1.0,0,0,0,1,1,0,0,0,1,2.0,0,3.0
GIB,2017,February,1,0,1,1.0,0,0,1,0,1,0,0,0,2,2.0,0,4.0
CPV,2017,January,2,0,2,1.0,0,2,2,0,2,0,0,0,5,0.0,0,5.0
MAC,2017,February,1,0,1,1.0,0,0,1,0,1,0,0,0,2,0.0,0,2.0
GIB,2016,March,2,0,2,1.0,0,3,2,0,2,0,0,0,5,0.0,0,5.0
ARE,2016,May,2,0,2,1.0,0,0,1,1,2,0,0,0,4,4.0,0,8.0
NGA,2016,March,4,0,4,1.0,0,2,4,0,4,0,0,0,7,2.0,0,9.0
PAK,2016,November,1,0,1,1.0,0,1,1,0,1,0,0,0,2,0.0,0,2.0
BGR,2016,August,1,0,1,1.0,0,1,1,0,1,0,0,0,2,0.0,0,2.0
ARE,2016,February,1,0,1,1.0,0,0,1,0,1,0,0,0,1,0.0,0,1.0
TUR,2017,February,3,0,3,1.0,0,2,3,0,3,0,0,0,5,1.0,0,6.0
URY,2017,August,2,0,2,1.0,0,4,2,0,2,0,0,0,5,0.0,0,5.0
MAC,2017,January,1,0,1,1.0,0,2,1,0,1,0,0,0,1,0.0,0,1.0
HKG,2016,October,4,0,4,1.0,0,0,4,0,4,0,0,0,8,0.0,0,8.0
KEN,2017,March,1,0,1,1.0,0,3,1,0,1,0,0,0,3,0.0,0,3.0
KWT,2017,May,1,0,1,1.0,0,1,1,0,1,0,0,0,2,0.0,0,2.0
JEY,2017,May,2,0,2,1.0,0,0,2,0,2,0,0,0,5,0.0,0,5.0
VEN,2017,January,2,0,2,1.0,0,0,2,0,2,0,0,0,3,0.0,0,3.0
CYP,2017,May,2,0,2,1.0,0,2,2,0,2,0,0,0,2,0.0,0,2.0
GIB,2017,August,4,0,4,1.0,0,6,1,3,4,0,0,0,8,0.0,0,8.0
IDN,2016,April,1,0,1,1.0,0,0,1,0,1,0,0,0,2,0.0,0,2.0
ARE,2016,December,2,0,2,1.0,0,4,2,0,2,0,0,0,4,0.0,0,4.0
ARE,2017,February,2,0,2,1.0,0,0,2,0,2,0,0,0,3,0.0,0,3.0
JEY,2016,September,2,0,2,1.0,0,1,1,1,2,0,0,0,4,0.0,0,4.0
TWN,2016,October,2,0,2,1.0,0,0,2,0,2,0,0,0,4,0.0,0,4.0
AND,2017,August,2,0,2,1.0,0,2,0,2,2,0,0,0,4,2.0,0,6.0
BHR,2017,April,1,0,1,1.0,0,1,1,0,1,0,0,0,2,1.0,0,3.0
URY,2017,June,1,0,1,1.0,0,2,0,1,1,0,0,0,2,0.0,0,2.0
VGB,2016,August,1,0,1,1.0,0,0,1,0,1,0,0,0,2,0.0,0,2.0
EGY,2017,August,1,0,1,1.0,0,1,1,0,1,0,0,0,2,0.0,0,2.0
ARE,2016,September,3,0,3,1.0,0,2,3,0,3,0,0,0,6,1.0,0,7.0
MYS,2017,March,1,0,1,1.0,0,0,1,0,1,0,0,0,1,0.0,0,1.0
AZE,2017,August,2,0,2,1.0,0,3,1,1,2,0,0,0,4,1.0,0,5.0
GEO,2016,July,2,0,2,1.0,0,1,1,1,2,0,0,0,3,0.0,0,3.0
SAU,2017,February,1,0,1,1.0,0,0,1,0,1,0,0,0,2,0.0,0,2.0
MOZ,2016,June,2,0,2,1.0,0,2,2,0,2,0,0,0,4,0.0,0,4.0
UKR,2016,September,1,0,1,1.0,0,1,1,0,1,0,0,0,2,0.0,0,2.0
CPV,2016,July,1,0,1,1.0,0,0,1,0,1,0,0,0,2,0.0,0,2.0
TUN,2016,July,2,0,2,1.0,0,0,2,0,2,0,0,0,4,1.0,0,5.0
DOM,2017,June,2,0,2,1.0,0,1,2,0,2,0,0,0,3,0.0,0,3.0
DOM,2017,July,5,0,5,1.0,0,0,5,0,5,0,0,0,10,8.0,0,18.0
THA,2017,August,1,0,1,1.0,0,0,1,0,1,0,0,0,1,0.0,0,1.0
MLT,2017,March,1,0,1,1.0,0,0,1,0,1,0,0,0,2,0.0,0,2.0
CPV,2016,April,1,0,1,1.0,0,0,1,0,1,0,0,0,3,0.0,0,3.0
KWT,2016,April,1,0,1,1.0,0,0,1,0,1,0,0,0,1,0.0,0,1.0
HKG,2016,September,1,0,1,1.0,0,1,0,1,1,0,0,0,2,0.0,0,2.0
HKG,2016,August,1,0,1,1.0,0,1,1,0,1,0,0,0,2,0.0,0,2.0
VEN,2016,January,1,0,1,1.0,0,0,1,0,1,0,0,0,1,0.0,0,1.0
HKG,2017,March,1,0,1,1.0,0,0,1,0,1,0,0,0,1,0.0,0,1.0
SEN,2017,March,2,0,2,1.0,0,4,2,0,2,0,0,0,4,0.0,0,4.0
MAR,2017,May,3,0,3,1.0,0,2,1,2,3,0,0,0,6,2.0,0,8.0
AND,2016,January,1,0,1,1.0,0,1,1,0,1,0,0,0,2,0.0,0,2.0
BIH,2016,December,2,0,2,1.0,0,0,2,0,2,0,0,0,4,0.0,0,4.0
KAZ,2017,January,1,0,1,1.0,0,1,1,0,1,0,0,0,1,0.0,0,1.0
IDN,2017,July,1,0,1,1.0,0,0,1,0,1,0,0,0,3,0.0,0,3.0
ARE,2017,May,2,0,2,1.0,0,2,1,1,2,0,0,0,3,2.0,0,5.0
ZWE,2017,August,2,0,2,1.0,0,0,2,0,2,0,0,0,4,0.0,0,4.0
IRN,2016,October,2,0,2,1.0,0,2,2,0,2,0,0,0,4,0.0,0,4.0
NGA,2016,November,3,0,3,1.0,0,2,3,0,3,0,0,0,6,0.0,0,6.0
COL,2016,August,1,0,1,1.0,0,1,1,0,1,0,0,0,2,1.0,0,3.0
MKD,2016,October,2,0,2,1.0,0,1,2,0,0,2,0,0,4,0.0,0,4.0
URY,2016,April,1,0,1,1.0,0,3,1,0,1,0,0,0,2,0.0,0,2.0
SAU,2016,September,2,0,2,1.0,0,0,2,0,2,0,0,0,2,2.0,0,4.0
TUN,2017,June,1,0,1,1.0,0,1,1,0,1,0,0,0,2,0.0,0,2.0
LBN,2016,August,2,0,2,1.0,0,2,2,0,2,0,0,0,4,0.0,0,4.0
VNM,2016,November,1,0,1,1.0,0,0,1,0,1,0,0,0,3,0.0,0,3.0
VEN,2016,December,2,0,2,1.0,0,0,2,0,2,0,0,0,4,0.0,0,4.0
ECU,2017,July,1,0,1,1.0,0,1,1,0,1,0,0,0,2,0.0,0,2.0
IDN,2016,February,2,0,2,1.0,0,0,2,0,2,0,0,0,2,0.0,0,2.0
PER,2016,May,1,0,1,1.0,0,0,1,0,1,0,0,0,1,0.0,0,1.0
ETH,2017,March,1,0,1,1.0,0,0,1,0,1,0,0,0,1,0.0,0,1.0
QAT,2017,July,6,0,6,1.0,0,6,6,0,6,0,0,0,16,1.0,0,17.0
CYP,2016,July,1,0,1,1.0,0,0,1,0,1,0,0,0,2,0.0,0,2.0
LVA,2017,August,1,0,1,1.0,0,0,0,1,1,0,0,0,3,1.0,0,4.0
PER,2016,November,3,0,3,1.0,0,5,3,0,3,0,0,0,4,0.0,0,4.0
THA,2017,April,2,0,2,1.0,0,0,2,0,2,0,0,0,4,4.0,0,8.0
BLR,2016,August,2,0,2,1.0,0,0,0,2,2,0,0,0,4,0.0,0,4.0
ZMB,2016,April,1,0,1,1.0,0,1,1,0,1,0,0,0,2,0.0,0,2.0
EGY,2016,September,3,0,3,1.0,0,1,3,0,3,0,0,0,6,2.0,0,8.0
KWT,2016,December,1,0,1,1.0,0,1,0,1,1,0,0,0,2,0.0,0,2.0
BHR,2017,August,2,0,2,1.0,0,2,1,1,2,0,0,0,3,0.0,0,3.0
CPV,2016,March,2,0,2,1.0,0,0,2,0,2,0,0,0,3,0.0,0,3.0
COL,2017,February,1,0,1,1.0,0,0,1,0,1,0,0,0,3,0.0,0,3.0
CIV,2017,August,2,0,2,1.0,0,2,2,0,2,0,0,0,3,0.0,0,3.0
CPV,2016,January,1,0,1,1.0,0,0,1,0,1,0,0,0,2,0.0,0,2.0
JOR,2016,September,1,0,1,1.0,0,0,1,0,1,0,0,0,2,0.0,0,2.0
PRI,2016,December,2,0,2,1.0,0,4,2,0,2,0,0,0,4,0.0,0,4.0
PAK,2016,March,3,0,3,1.0,0,1,3,0,3,0,0,0,5,0.0,0,5.0
LTU,2017,February,1,0,1,1.0,0,0,1,0,1,0,0,0,2,0.0,0,2.0
TZA,2017,February,1,0,1,1.0,0,0,1,0,1,0,0,0,2,0.0,0,2.0
MCO,2016,April,1,0,1,1.0,0,1,1,0,1,0,0,0,2,0.0,0,2.0
CPV,2016,June,2,0,2,1.0,0,0,2,0,2,0,0,0,4,0.0,0,4.0
LBN,2016,March,1,0,1,1.0,0,0,1,0,1,0,0,0,1,0.0,0,1.0
ARE,2017,March,6,0,6,1.0,0,2,6,0,6,0,0,0,10,4.0,0,14.0
EGY,2017,March,2,0,2,1.0,0,2,2,0,2,0,0,0,2,2.0,0,4.0
IDN,2017,August,1,0,1,1.0,0,0,1,0,1,0,0,0,2,2.0,0,4.0
NIC,2016,May,1,0,1,1.0,0,0,1,0,1,0,0,0,2,1.0,0,3.0
ARE,2016,August,1,0,1,1.0,0,0,1,0,1,0,0,0,3,0.0,0,3.0
MOZ,2016,September,1,0,1,1.0,0,0,1,0,1,0,0,0,2,0.0,0,2.0
BGD,2016,December,3,0,3,1.0,0,0,3,0,3,0,0,0,8,1.0,0,9.0
MAC,2017,May,3,0,3,1.0,0,0,3,0,3,0,0,0,3,0.0,0,3.0
HKG,2017,June,2,0,2,1.0,0,0,2,0,2,0,0,0,4,0.0,0,4.0
CPV,2016,December,1,0,1,1.0,0,1,1,0,1,0,0,0,2,0.0,0,2.0
KEN,2016,December,1,0,1,1.0,0,1,1,0,1,0,0,0,3,0.0,0,3.0
NGA,2017,March,2,0,2,1.0,0,2,2,0,2,0,0,0,4,0.0,0,4.0
SEN,2016,February,1,0,1,1.0,0,0,1,0,1,0,0,0,2,0.0,0,2.0
LTU,2016,April,2,0,2,1.0,0,0,2,0,2,0,0,0,3,0.0,0,3.0
TJK,2016,May,8,0,8,1.0,0,0,8,0,8,0,0,0,16,0.0,0,16.0
ARE,2016,June,3,0,3,1.0,0,0,3,0,3,0,0,0,7,2.0,0,9.0
SAU,2017,May,1,0,1,1.0,0,1,1,0,1,0,0,0,3,0.0,0,3.0
JEY,2016,November,1,0,1,1.0,0,1,0,1,1,0,0,0,2,0.0,0,2.0
GGY,2016,July,2,0,2,1.0,0,0,2,0,2,0,0,0,4,0.0,0,4.0
KOR,2016,August,2,0,2,1.0,0,1,2,0,2,0,0,0,4,0.0,0,4.0
PHL,2016,November,1,0,1,1.0,0,0,1,0,1,0,0,0,1,0.0,0,1.0
IMN,2017,April,1,0,1,1.0,0,2,1,0,1,0,0,0,2,1.0,0,3.0
MUS,2016,August,1,0,1,1.0,0,0,1,0,1,0,0,0,2,1.0,0,3.0
GHA,2017,July,1,0,1,1.0,0,1,1,0,1,0,0,0,3,0.0,0,3.0
SYC,2017,July,1,0,1,1.0,0,1,0,1,1,0,0,0,2,0.0,0,2.0
TUN,2016,March,2,0,2,1.0,0,1,2,0,2,0,0,0,4,0.0,0,4.0
ARE,2016,March,2,0,2,1.0,0,1,2,0,2,0,0,0,4,0.0,0,4.0
HKG,2016,July,3,0,3,1.0,0,0,3,0,3,0,0,0,8,0.0,0,8.0
KAZ,2017,June,1,0,1,1.0,0,1,0,1,1,0,0,0,2,2.0,0,4.0
SVK,2017,June,3,0,3,1.0,0,1,1,2,3,0,0,0,6,4.0,0,10.0
UZB,2016,April,1,0,1,1.0,0,0,1,0,1,0,0,0,1,0.0,0,1.0
MDV,2017,March,1,0,1,1.0,0,2,0,1,1,0,0,0,2,0.0,0,2.0
MOZ,2017,August,2,0,2,1.0,0,2,1,1,2,0,0,0,5,0.0,0,5.0
TUN,2017,August,1,0,1,1.0,0,0,1,0,1,0,0,0,2,2.0,0,4.0
PAK,2016,April,1,0,1,1.0,0,0,1,0,1,0,0,0,1,0.0,0,1.0
CRI,2016,September,1,0,1,1.0,0,0,1,0,1,0,0,0,2,0.0,0,2.0
MNE,2017,April,1,0,1,1.0,0,2,1,0,1,0,0,0,2,1.0,0,3.0
EGY,2017,May,1,0,1,1.0,0,0,1,0,1,0,0,0,2,0.0,0,2.0
NOR,2016,December,1,0,1,1.0,0,0,1,0,1,0,0,0,2,0.0,0,2.0
SEN,2017,January,1,0,1,1.0,0,0,1,0,1,0,0,0,1,0.0,0,1.0
KWT,2017,August,2,0,2,1.0,0,2,2,0,2,0,0,0,6,0.0,0,6.0
ZAF,2016,October,2,0,2,1.0,0,3,0,2,2,0,0,0,4,0.0,0,4.0
VNM,2016,October,1,0,1,1.0,0,0,1,0,1,0,0,0,1,0.0,0,1.0
OMN,2017,June,1,0,1,1.0,0,0,1,0,1,0,0,0,2,2.0,0,4.0
BLR,2017,January,1,0,1,1.0,0,0,1,0,1,0,0,0,2,0.0,0,2.0
SGP,2016,March,1,0,1,1.0,0,0,1,0,1,0,0,0,2,0.0,0,2.0
COL,2016,November,4,0,4,1.0,0,1,2,2,4,0,0,0,7,0.0,0,7.0
AGO,2016,April,7,0,7,1.0,0,0,7,0,7,0,0,0,10,2.0,0,12.0
UZB,2017,January,1,0,1,1.0,0,1,1,0,1,0,0,0,2,0.0,0,2.0
TMP,2016,December,1,0,1,1.0,0,2,1,0,1,0,0,0,2,0.0,0,2.0
GEO,2016,April,1,0,1,1.0,0,0,1,0,1,0,0,0,2,0.0,0,2.0
TUN,2016,August,1,0,1,1.0,0,1,1,0,1,0,0,0,2,0.0,0,2.0
GNB,2017,February,1,0,1,1.0,0,0,1,0,1,0,0,0,2,0.0,0,2.0
ARE,2016,November,1,0,1,1.0,0,1,0,1,1,0,0,0,1,0.0,0,1.0
IDN,2016,July,2,0,2,1.0,0,0,2,0,2,0,0,0,4,1.0,0,5.0
PAK,2017,January,1,0,1,1.0,0,0,1,0,1,0,0,0,2,0.0,0,2.0
PHL,2017,May,5,0,5,1.0,0,2,5,0,5,0,0,0,11,0.0,0,11.0
DOM,2017,January,1,0,1,1.0,0,0,1,0,1,0,0,0,2,0.0,0,2.0
PHL,2017,April,1,0,1,1.0,0,0,1,0,1,0,0,0,1,0.0,0,1.0
BHR,2017,May,1,0,1,1.0,0,3,1,0,1,0,0,0,2,2.0,0,4.0
MOZ,2017,June,1,0,1,1.0,0,2,1,0,1,0,0,0,2,0.0,0,2.0
IDN,2016,December,10,0,10,1.0,0,0,10,0,10,0,0,0,20,0.0,0,20.0
BGD,2017,July,1,0,1,1.0,0,1,1,0,1,0,0,0,2,0.0,0,2.0
SEN,2016,November,1,0,1,1.0,0,0,1,0,1,0,0,0,1,0.0,0,1.0
GAB,2017,August,1,0,1,1.0,0,0,1,0,1,0,0,0,2,0.0,0,2.0
SAU,2016,February,6,0,6,1.0,0,0,6,0,4,2,0,0,11,0.0,0,11.0
ALB,2016,April,1,0,1,1.0,0,0,1,0,1,0,0,0,2,0.0,0,2.0
ISL,2016,July,2,0,2,1.0,0,0,2,0,2,0,0,0,2,0.0,0,2.0
TWN,2017,February,2,0,2,1.0,0,0,2,0,2,0,0,0,6,0.0,0,6.0
MAC,2017,March,7,0,7,1.0,0,6,7,0,7,0,0,0,14,0.0,0,14.0
IND,2017,August,1,0,1,1.0,0,0,1,0,1,0,0,0,1,0.0,0,1.0
